a	/ei, ə/*  danh từ,  số nhiều as,  a's- (thông tục) loại a, hạng nhất, hạng tốt nhất hạng rất tốt=his health is a+ sức khoẻ anh ta vào loại a- (âm nhạc) la=a sharp+ la thăng=a flat+ la giáng- người giả định thứ nhất; trường hợp giả định thứ nhất=from a to z+ từ đầu đến đuôi, tường tận=not to know a from b+ không biết tí gì cả; một chữ bẻ đôi cũng không biết*  mạo từ- một; một (như kiểu); một (nào đó)=a very cold day+ một ngày rất lạnh=a dozen+ một tá=a few+ một ít=all of a size+ tất cả cùng một cỡ=a Shakespeare+ một (văn hào như kiểu) Sếch-xpia=a Mr Nam+ một ông Nam (nào đó)- cái, con, chiếc, cuốn, người, đứa...;=a cup+ cái chén=a knife+ con dao=a son of the Party+ người con của Đảng=a Vietnamese grammar+ cuốn ngữ pháp Việt Nam*  giới từ- mỗi, mỗi một=twice a week+ mỗi tuần hai lần
a b	adđ
a b c	/'eibi:'si:/*  danh từ- bảng chữ cái- khái niệm cơ sở, cơ sở=a_b_c of chemistry+ khái niệm cơ sở về hoá học, cơ sở hoá học- (ngành đường sắt) bảng chỉ đường theo abc
a b c - book	/'eibi:'si:buk/*  danh từ- sách vỡ lòng, sách học vần
a b d	a-hh
a font	/ɑ:'fɜ:ɳ/*  phó từ- thấu triệt, cặn kẽ, rõ ngọn nghành
a fortiori	/'ei,fɔ:ti'ɔ:rai/*  phó từ- huống hồ, huống là
a hng	a-* hung
a hung	a-* b-c
a la carte	/'ɑ:lɑ:'kɑ:t/*  phó từ- theo món, gọi theo món, đặt theo món=to dine a_la_carte+ ăn cơm gọi theo món
a la mode	/,ɑ:lə'moud/*  phó từ- hợp thời trang, đúng mốt
a posteriori	/'eipɔs,teri'ɔ:rai/*  phó từ & tính từ- theo phép quy nạp=method a_posteriori+ phương pháp quy nạp- hậu nghiệm=probability a_posteriori+ (toán học) xác suất hậu nghiệm
a priori	/'eiprai'ɔ:rai/*  danh từ & phó từ- theo cách suy diễn, theo cách diễn dịch- tiên nghiệm=probability a_priori+ (toán học) xác xuất tiên nghiệm
a-bomb	/'ei'bɔm/*  danh từ- bom nguyên tử
a-going	/ə'gouiɳ/*  tính từ & phó từ- đang chạy, đang chuyển động; đang hoạt động, đang tiến hành=to set a-going+ cho chuyển động, cho chạy (máy...)
a-plenty	/ə'plenti/*  phó từ- (từ Mỹ,nghĩa Mỹ) nhiều, dồi dào, phong phú
a-power	/'ei'pauə/*  danh từ- năng lượng nguyên tử- cường quốc nguyên tử
a.d.	/'ei'di:/*  (viết tắt) của Ano Domin- sau công nguyên=1540 a.d.+ năm 1540 sau công nguyên
a.m.	/'ei'em/*  phó từ- (xem) ante_meridiem
aard-wolf	/'ɑ:d,wulf/*  danh từ- (động vật học) chó sói đất (Nam Phi)
aasvogel	/'ɑ:sfougəl/*  danh từ- (động vật học) con kên kên (Nam Phi)
aba	/'ɑ:bə/*  danh từ- áo aba (áo ngoài giống hình cái túi người A-Rập)
abaci	/'æbəkəs/*  danh từ,  số nhiều abaci,  abacuses- bàn tính=to move counters of an abacus; to work an abacus+ tính bằng bàn tính, gảy bàn tính- (kiến trúc)- đầu cột, đỉnh cột
aback	/ə'bæk/*  phó từ- lùi lại, trở lại phía sau=to stand aback from+ đứng lùi lại để tránh- (hàng hải) bị thổi ép vào cột buồm (buồm)=to be taken aback+ (hàng hải) bị gió thổi ép vào cột buồm- (nghĩa bóng) sửng sốt, ngạc nhiên=to be taken aback by the news+ sửng sốt vì cái tin đó
abacus	/'æbəkəs/*  danh từ,  số nhiều abaci,  abacuses- bàn tính=to move counters of an abacus; to work an abacus+ tính bằng bàn tính, gảy bàn tính- (kiến trúc)- đầu cột, đỉnh cột
abaddon	/ə'bædən/*  danh từ- âm ti, địa ngục- con quỷ
abaft	/ə'bɑ:ft/*  phó từ- (hàng hải) ở phía sau bánh lái, gần phía bánh lái*  giới từ- (hàng hải) sau, ở đằng sau, ở phía sau=abaft the mast+ sau cột buồm
b	/bi:/*  danh từ,  số nhiều Bs,  B's- b- (âm nhạc) xi- người thứ hai; vật thứ hai (trong giả thuyết)!b flat- (âm nhạc) xi giáng-(đùa cợt) con rệp!not to know B from a bull's foot (brom a broom-stick, from a bufalo foot)- không biết gì cả, dốt đặc cán mai
b.a.	/'bi:'ei/*  danh từ- (viết tắt) của Bachelor-of-Arts tú tài văn chương
b.b.c	/'bi:bi:'si:/*  (viết tắt) của British Broad-casting Corporation đài B.B.C. (Anh)
b.c	/'bi:'si:/*  (viết tắt) của before Christ trước công lịch
baa	/bɑ:/*  danh từ- tiếng be be (cừu)*  nội động từ- kêu be be (cừu)
baa-lamb	/'bɑ:læm/*  danh từ- khuấy khoán['bæbit'metl]*  danh từ- (kỹ thuật) hợp kim babit
babbit-metal	/'bæbit'metl/*  danh từ- (kỹ thuật) hợp kim babit
babble	/'bæbl/*  danh từ+ (babblement) /'bæblmənt/- tiếng bập bẹ, tiếng bi bô (trẻ con)- sự nói lảm nhảm, sự- tiếng rì rào, tiếng róc rách (suối)- sự tiết lộ (bí mật)*  động từ- bập bẹ, bi bô (trẻ con)- nói nhiều, nói lảm nhảm, bép xép- rì rào, róc rách (suối)- tiết lộ (bí mật)
babblement	/'bæbl/*  danh từ+ (babblement) /'bæblmənt/- tiếng bập bẹ, tiếng bi bô (trẻ con)- sự nói lảm nhảm, sự- tiếng rì rào, tiếng róc rách (suối)- sự tiết lộ (bí mật)*  động từ- bập bẹ, bi bô (trẻ con)- nói nhiều, nói lảm nhảm, bép xép- rì rào, róc rách (suối)- tiết lộ (bí mật)
babbler	/'bæblə/*  danh từ- người nói nhiều; người hay bép xép- người tiết lộ bí mạt- (động vật học) chim hét cao cẳng
babe	/beib/*  danh từ- (thơ ca) trẻ sơ sinh, - người khờ dại, người ngây thơ, người không có kinh nghiệm- (từ Mỹ,nghĩa Mỹ),  (từ lóng) cô gái xinh xinh!babes and sucklings- những người mới ra đời, những người mới vào nghề hoàn toàn chưa có kinh nghiệm!babes in the wood- những người khờ dại, những người cả tin
babel	/'beibəl/*  danh từ- (kinh thánh) (Babel) tháp Ba-ben- toà nhà cao; công trình kiến trúc to lớn- kế hoạch ảo tưởng- mớ hỗn độn những tiếng nói khác nhau
babittry	/'bæbitri/*  danh từ- tư tưởng Ba-bít (nhân vật tiểu thuyết, trung thành với tư tưởng, lý tưởng của gia cấp tiểu tư sản, tự mãn với lối sống khá giả của mình)
baboon	/bə'bu:n/*  danh từ- (động vật học) khỉ đầu chó
babouche	/bə'bu:ʃ (papoosh) pə'pu:ʃ/*  danh từ- giày hạ, hài (A-ÃRập)
baby	/'beibi/*  danh từ- đứa bé mới sinh; trẻ thơ- người tính trẻ con- (định ngữ) nhỏ; xinh xinh=a baby car+ chiếc ôtô nhỏ- (từ Mỹ,nghĩa Mỹ),  (từ lóng) người yêu; con gái!to carry (hold) the baby- phải gánh một trách nhiệm không thích thú gì!to give somebody a baby to hold- bó chân bó tay ai- bắt ai phải gánh một trách nhiệm không thích thú gì!to play the baby- nghịch cái kiểu trẻ con; làm ra vẻ trẻ con!to plead the baby act- trốn trách nhiệm lấy cớ là không có kinh nghiệm!to smell of the baby- có vẻ trẻ con; có tính trẻ con!sugar baby- (từ Mỹ,nghĩa Mỹ),  (từ lóng) người yêu
baby buggy	/'beibi'bʌgi/*  danh từ- xe đẩy trẻ con
baby-farm	/'beibifɑ:m/*  danh từ- nhà giữ trẻ
baby-farmer	/'beibi,fɑ:mə/*  danh từ- người giữ trẻ
baby-farming	/'beibi,fɑ:miɳ/*  danh từ- việc giữ trẻ
baby-jumper	/'beibi,dʤʌmpə/*  danh từ- cái khung tập đi
baby-sit	/'beibisit/*  nội động từ- giữ trẻ hộ (trong khi bố mẹ đi vắng)
baby-sitter	/'beibi,sitə/*  danh từ- (thực vật học) người giữ trẻ hộ (trong khi bố mẹ đi vắng) ((cũng) sitter,  sitter-in)
babyhood	/'beibihud/*  danh từ- tuổi thơ
babyish	/'beibiiʃ/*  tính từ- trẻ con, như trẻ con
babyishness	/'beibiiʃnis (babyism) 'beibiizm/*  danh từ- tính trẻ con, tính như trẻ con
babyism	/'beibiiʃnis (babyism) 'beibiizm/*  danh từ- tính trẻ con, tính như trẻ con
baccalaureate	/,bækə'lɔ:riit/*  danh từ- bằng tú tài
baccarat	/'bækərɑ:/*  danh từ- (đánh bài) trò chơi bacara
bacchanal	/'bækənl (Bacchic) 'bækik/*  tính từ- (thuộc) thần Bắc-cút- chè chén ồn ào=bacchanal feast+ bữa chè chén ồn ào
bacchanalia	/,bækə'neiljə/*  danh từ- thầy tế thần rượu Bắc-cút- người chè chén say sưa- cuộc chè chén say sưa ồn ào- điệu vũ ca ngợi thần Bắc-cút
bacchanalian	/,bækə'neiljən/*  danh từ- (số nhiều) buổi tế thần rượu Bắc-cút- cuộc chè chén say sưa*  tính từ- (thuộc) ngày tế thần rượu Bắc-cút- chè chén say sưa*  danh từ- người say rượu
bacchant	/'bækənt/*  danh từ- thầy tế thần rượu Bắc-cút- đồ đệ của thần rượu Bắc-cút
bacchic	/'bækənl (Bacchic) 'bækik/*  tính từ- (thuộc) thần Bắc-cút- chè chén ồn ào=bacchanal feast+ bữa chè chén ồn ào
bacchus	/'bækəs/*  danh từ- (thần thoại,thần học) thần rượu Bắc-cút
bacciferous	/bæk'sifərəs/*  tính từ- (thực vật học) có quả mọng, mang quả mọng
bacciform	/'bæksifɔ:m/*  tính từ- hình quả mọng
baccivorous	/bæk'sivərəs/*  tính từ- (động vật học) ăn quả mọng
baccy	/'bæki/*  danh từ- (thông tục) thuốc lá
bachelor	/'bætʃələ/*  danh từ- người chưa vợ- (người đậu bằng) tú tài=Bachelor of Arts+ tú tài văn chương- (sử học) kỵ sĩ, hiệp sĩ!bachelor girl- cô gái sống độc thân, cô gái ở vậy
bachelorhood	/'bætʃələhud/*  danh từ- đời sống độc thân
bachelorship	/'bætʃələʃip/*  danh từ- (như) bachelorhood- sự tốt nghiệp bằng tú tài
bacillary	/bə'siləri/*  tính từ- (thuộc) khuẩn que- hình que- gồm nhiều que
bacilli	/bə'siləs/*  (bất qui tắc) danh từ,  số nhiều bacilli /bə'silai/- khuẩn que
bacilliform	/bə'silifɔ:m/*  tính từ- hình que
c	/si:/*  danh từ,  số nhiều Cs,  C's- c- 100 (chữ số La mã)- (từ Mỹ,nghĩa Mỹ) trăm đô la- (âm nhạc) đô- (toán học) số lượng thứ ba đã biết- (từ Mỹ,nghĩa Mỹ) Côcain- người thứ ba, vật thứ ba (trong giả thiết)- vật hình c
c.o.d.	/'si:oudi:/*  (viết tắt) của cash on delivery, trả tiền lúc nhận hàng
cab	/kæb/*  danh từ- xe tắc xi; xe ngựa thuê- (ngành đường sắt) buồng lái- cabin, buồng lái (ở xe vận tải)*  nội động từ- đi xe tắc xi; đi xe ngựa thuê
cab-rank	/'kæbræɳk/*  danh từ- dãy xe tắc xi chở khách; dãy xe ngựa chở khách
cab-runner	/'kæb,rʌnə (cab-tout) 'kæbtaut/-tout) /'kæbtaut/*  danh từ- người làm nghề đi gọi xe tắc xi; người làm nghề đi gọi xe ngựa thuê- người xếp dở hành lý (trên xe tắc xi hoặc xe ngựa)
cab-stand	/'kæbstænd/*  danh từ- bến xe tắc xi; bến xe ngựa
cab-tout	/'kæb,rʌnə (cab-tout) 'kæbtaut/-tout) /'kæbtaut/*  danh từ- người làm nghề đi gọi xe tắc xi; người làm nghề đi gọi xe ngựa thuê- người xếp dở hành lý (trên xe tắc xi hoặc xe ngựa)
cabal	/kə'bæl/*  danh từ- âm mưu- bè đảng, phe đảng (chính trị)*  nội động từ- âm mưu, mưu đồ
cabala	/kə'bɑ:lə/*  danh từ- (như) cabbala- (từ hiếm,nghĩa hiếm) (như) cabal
cabalism	/kə'bɑ:lizm (cabalism) kə'bɑ:lizm/*  danh từ- cách học pháp thuật; cách luyện phù chú- thuật thuần bí, thuật phù thuỷ
cabalistic	/,kæbə'listik/*  tính từ- (như) cabbalistic
caballer	/kə'bælə/*  danh từ- người âm mưu, người mưu đồ
cabaret	/'kæbərei/*  danh từ- quán rượu Pháp- trò múa hát mua vui trong các tiệm (tiệm ăn, quán rượu, hộp đêm ở Mỹ,  Anh) ((cũng) cabaret_show)
cabaret show	/'kæbəreiʃou/*  danh từ- trò múa hát mua vui trong các tiệm (tiệm ăn, quán rượu, hộp đêm ở Mỹ,  Anh) ((cũng) cabaret)
cabbage	/'kæbidʤ/*  danh từ- cải bắp- (từ lóng)- tiền, xìn, giấy bạc*  danh từ- mẩu vải thừa; mẩu vải ăn bớt (thợ may)*  nội động từ- ăn bớt vải (thợ may)*  danh từ- (từ lóng) bài dịch từng chữ một, bài dịch để quay cóp
cabbage-head	/'kæbidʤhed/*  danh từ- bắp cải- (thông tục) người ngu đần, người ngốc nghếch
cabbala	/kə'bɑ:lə (kabbalah) kə'bɑ:lə/*  danh từ- phép thần thông, pháp thuật (của người Do thái)
cabbalism	/kə'bɑ:lizm (cabalism) kə'bɑ:lizm/*  danh từ- cách học pháp thuật; cách luyện phù chú- thuật thuần bí, thuật phù thuỷ
cabbalistic	/,kæbə'listik/*  tính từ- (thuộc) phép thần thông, (thuộc) pháp thuật- thần bí, bí hiểm
cabby	/'kæbi/*  danh từ- (thông tục) người lái tắc xi; người đánh xe ngựa
caber	/'keibə/*  danh từ- sào, lao (bằng thân cây thông non dùng trong một trò chơi thể thao ở Ê-cốt)!tossing the caber- trò chơi ném lao
cabin	/'kæbin/*  danh từ- cabin, buồng ngủ (ở tàu thuỷ, máy bay)- nhà gỗ nhỏ, túp lều*  ngoại động từ,  (thường) dạng bị động- nhốt vào chỗ chật hẹp
cabin-boy	/'kæbinbɔi/*  danh từ- bồi tàu, cậu bé phục vụ dưới tàu
cabin-class	/'læbinklɑ:s/*  danh từ- hạng hai (hạng vé trên tàu thuỷ, máy bay)
cabinet	/'kæbinit/*  danh từ- tủ (có nhiều ngăn, đựng đồ dạc quý)=a medicine cabinet+ tủ đựng thuốc=a filing cabinet+ tủ đựng hồ sơ=a china cabinet+ tủ đựng cốc tách bát đĩa- vỏ (máy thu thanh, máy ghi âm)- nội các, chính phủ=cabinet minister+ thành viên nội các, bộ trưởng=cabinet minister+ thành viên nội các, bộ trưởng=cabinet council+ hội đồng nội các; hội đồng chính phủ=cabinet crisis+ khủng hoảng nội các- phòng riêng
cabinet-maker	/'kæbinit,meikə/*  danh từ- thợ đóng đồ gỗ mỹ thuật-(đùa cợt) người lập chính phủ mới
cabinet-making	/'kæbinit,meikiɳ/*  danh từ- (như) cabinet-work-(đùa cợt) sự lập chính phủ mới
cabinet-work	/'kæbinitwə:k/*  danh từ ((cũng) cabinet-making)- đồ gỗ mỹ thuật- nghề làm đồ gỗ mỹ thuật
cable	/'keibl/*  danh từ- dây cáp- cáp xuyên đại dương- (như) cablegram- (hàng hải) dây neo- (hàng hải) tầm (1 qoành 0 hải lý tức 183m,  (từ Mỹ,nghĩa Mỹ) 219m) ((cũng) cable length)- đường viền xoắn (quanh cột); đường chạm xoắn (vòng vàng)!to cut (slip) one's cables- (từ lóng) chết ngoẻo*  động từ- cột bằng dây cáp, buộc bằng dây cáp- đánh điện xuyên đại dương; đánh cáp- trang bị bằng đường viền xoắn (cột)
cable-car	/'keiblkɑ:/*  danh từ- toa (xe kéo bằng dây) cáp
cablegram	/'keiblgræm/*  danh từ- bức điện xuyên đại dương; điện tín, cáp
cablerailway	/'keibl'reilwei/*  danh từ- đường sắt cho toa (xe kéo bằng dây) cáp
cabman	/'kæbmən/*  danh từ- người lái tăc xi; người đánh xe ngựa thuê
caboodle	/kə'bu:dl/*  danh từ- (từ lóng)=the whoole caboodle+ cả bọn, cả lũ, cả lô, cả mớ
caboose	/kə'bu:s/*  danh từ- (hàng hải) bếp trên boong- (từ Mỹ,nghĩa Mỹ) toa dành cho công nhân- (từ Mỹ,nghĩa Mỹ) bếp lò đun ngoài trời
cabotage	/'kæbətɑ:ʤ/*  danh từ- sự buôn bán dọc theo bờ biển
cabriolet	/,kæbriou'lei/*  danh từ- xe độc mã- xe ô tô cụp mui, xe mui trần
cacao	/kekɑ:ou/*  danh từ- (như) cacao-tree- hột cacao
cacao-tree	/kə'kɑ:outri:/*  danh từ- (thực vật học) cây cacao ((cũng) cacao)
cachalot	/'kæʃəlɔt/*  danh từ- (động vật học) cá nhà táng
cache	/kæʃ/*  danh từ- nơi giấu, nơi trữ (lương thực, đạn dược... nhất là các nhà thám hiểm để dùng sau này)=to make a cache+ xây dựng nơi trữ- lương thực, vật dụng giấu kín- thức ăn dự trữ (của động vật qua đông)*  ngoại động từ- giấu kín, trữ
cachet	/'kæʃei/*  danh từ- dấu đặc biệt, nét đặc sắc- dấu chứng thực; dấu ấn- (dược học) viên con nhện
cachetic	/kə'keitik/*  tính từ- (y học) suy mòn
cachexy	/kə'keksi/*  danh từ- (y học) bệnh suy mòn
cachinnate	/'kækineit/*  nội động từ- cười rộ, cười vang
cachinnation	/,kæki'neiʃn/*  danh từ- tiếng cười rộ, tiếng cười vang
cachou	/kə'ʃu:/*  danh từ- kẹo caosu
cack	/kæk/*  danh từ- giày không gót (của trẻ con)*  danh từ- khuồi(đùa cợt), phân*  nội động từ- ruộc sáu uộng['kækl]*  danh từ- tiếng gà cục tác- tiếng cười khúc khích- chuyện mách qué, chuyện ba toác, chuyện vớ vẩn; chuyện ba hoa khoác lác!cut the cack!- câm cái mồm đi*  động từ- cục tác (gà mái)- cười khúc khích- nói dai, nói lảm nhảm, nói mách qué; ba hoa khoác lác
cackle	/'kækl/*  danh từ- tiếng gà cục tác- tiếng cười khúc khích- chuyện mách qué, chuyện ba toác, chuyện vớ vẩn; chuyện ba hoa khoác lác!cut the cackle!- câm cái mồm đi*  động từ- cục tác (gà mái)- cười khúc khích- nói dai, nói lảm nhảm, nói mách qué; ba hoa khoác lác
cacodylate	/'kækədileit/*  danh từ- (hoá học) cacođylat
cacography	/kæ'kɔgrəfi/*  danh từ- sự viết tồi, sự đọc tồi
cacology	/kæ'kɔlədʤi/*  danh từ- sự chọn từ tồi- sự phát âm tồi
cacophonous	/kæ'kɔfənəs/*  tính từ- nghe chối tai- không hoà hợp, không ăn khớp
cacophony	/kæ'kɔfəni/*  danh từ- tiếng lộn xộn chối tai; điệu nhạc chối tai (có nhiều âm thanh không hoà hợp với nhau)- (ngôn ngữ học) âm hưởng xấu- (âm nhạc) âm tạp- (nghĩa bóng) sự không hoà hợp, sự không ăn khớp
cactaceous	/kæ'kæk'teiʃəs/*  tính từ- (thuộc) họ xương rồng
cacti	/'kæktəs/*  (bất qui tắc) danh từ,  số nhiều cacti /'kæktai/- (thực vật học) cây xương rồng
cactus	/'kæktəs/*  (bất qui tắc) danh từ,  số nhiều cacti /'kæktai/- (thực vật học) cây xương rồng
cacuminal	/kæ'kju:minl/*  tính từ- (ngôn ngữ học) uốn lưỡi (âm)
cad	/kæd/*  danh từ- đồ ti tiện, đồ vô lại, đồ đểu cáng, kẻ đáng khinh- (từ cổ,nghĩa cổ) người lái xe khách- (từ cổ,nghĩa cổ) đứa bé để sai vặt; đứa bé nhặt bóng
cadastral	/kə'dæstrəl/*  tính từ- (thuộc) địa chính
cadaveric	/kə'dævərik/*  tính từ- (y học) (thuộc) xác chết
cadaverous	/kə'dævərəs/*  tính từ- trông như xác chết- tái nhợt
cadaverousness	/kə'dævərəsnis/*  danh từ- vẻ như xác chết- sắc tái nhợt
d	/di:/*  danh từ,  số nhiều Ds,  D's- Đ,  đ 2 500 (chữ số La-mã)- (âm nhạc) rê- vật hình D (bu-lông, van...)
d'ye	/djə/*  (viết tắt) của do you
d-day	/'di:dei/*  danh từ- ngày đổ bộ (ngày quân Anh,  Mỹ đổ bộ lên miền bắc nước Pháp (6 6 1944) trong đại chiến II)- ngày nổ súng, ngày khởi hấn
d.ration	/'di:'ræʃn/*  danh từ- (từ Mỹ,nghĩa Mỹ),  (quân sự) khẩu phần dự phòng
da	/dɑ:/*  danh từ- (thông tục) (như) dad
dab	/dæb/*  ngoại động từ- đánh nhẹ, vỗ nhẹ, mổ nhẹ, gõ nhẹ=to dab with one's finger+ lấy ngón tay gõ nhẹ- chấm chấm nhẹ=to dab one's forehead with a handkerchief+ chấm chấm nhẹ trán bằng khăn tay=to dab paint on something+ chấm nhẹ sơn lên vật gì- (kỹ thuật) đột nhẹ*  danh từ- sự (cái) đánh nhẹ, sự (cái) mổ nhẹ- sự chấm chấm nhẹ (mồ hôi, phấn); sự (cái) chấm nhẹ (sơn...); sự thấm (bằng bọt biển...)=to give a picture a dab of paint+ phết nhẹ sơn lên bức hoạ- miếng, cục (cái gì mềm)=a dab of cheese+ miếng phó mát- vết (mực, sơn)*  danh từ- (động vật học) cá bơn*  danh từ- (từ lóng) tay giỏi, tay cừ, tay thạo=he is a dab at maths+ hắn là tay giỏi toán*  tính từ- (từ lóng) tài, giỏi, khéo, cừ; thạo=he is a dab hand at painting+ hắn ta vẽ rất cừ
dabber	/'dæbə/*  danh từ- người đánh nhẹ, người vỗ nhẹ, người xoa nhẹ- người chấm nhẹ, người thấm nhẹ- nùi vải, nùi bông, miếng bọt biển (để chấm, thấm...)- (ngành in) trục lăn mực (lên bản in)
dabble	/'dæbl/*  ngoại động từ- vẩy, rảy (nước); nhúng vào nước, làm ướt*  nội động từ- vầy, lội, mò, khoắng- (nghĩa bóng) (+ in,  at) làm chơi, làm bời, làm theo kiểu tài tử, học đòi=to dabble in poetry+ học đòi làm thơ
dabbler	/'dæblə/*  danh từ- người vầy, người mò, người khoắng- (nghĩa bóng) người làm chơi làm bời, người làm theo kiểu tài tử, người học đòi=a dabbler in poetry+ người học đòi làm thơ
dabchick	/'dæbtʃik/*  danh từ- (động vật học) chim lặn
dabster	/'dæbstə/*  danh từ- người thạo, người sành sỏi- (thông tục) (như) dauber
dace	/deis/*  danh từ- (động vật học) cá đác (họ cá chép)
dachshund	/'dækshund/*  danh từ- (động vật học) chó chồn (loài chó giống chồn, mình dài, chân ngắn)
dacoit	/də'kɔit/*  danh từ- (Anh-Ân) giặc, cướp có vũ trang
dacoity	/də'kɔiti/*  danh từ- (Anh-Ân) sự cướp bóc
dactyl	/'dæktil/*  danh từ- (thơ ca) Đactin (thể thơ gồm một âm tiết dài và âm tiết ngắn)
dactylic	/dæk'tilik/*  tính từ- (thuộc) đactin*  danh từ- thơ đactin
dactylogram	/dæk'tiləgræm/*  danh từ- dấu ngón tay
dactylography	/,dækti'lɔgrəfi/*  danh từ- khoa nghiên cứu dấu ngón tay (để nhận dạng)
dactylogy	/,dækti'lɔlədʤi/*  danh từ- (ngôn ngữ học) ngôn ngữ ngón tay
dad	/dæd (daddy) 'dædi/*  danh từ- (thông tục) ba, cha, bố, thầy
daddy	/dæd (daddy) 'dædi/*  danh từ- (thông tục) ba, cha, bố, thầy
dado	/'deidou/*  danh từ- phần chân tường (lát gỗ hoặc quét màu khác...)- thân bệ
dady-long-legs	/'dædi'lɔɳlegz/*  danh từ- (động vật học) con chôm chôm ((cũng) harvestman)
daedal	/'di:dl/*  tính từ- thơ khéo léo, tinh vi- phức tạp, rối rắm, như trận đồ bát quái
daedalian	/di:'deiljən/*  tính từ- phức tạp, rối rắm, như trận đồ bát quái
daemon	/'di:mən (daemon) 'di:mən/*  danh từ- ma quỷ, yêu ma, ma quái- người độc ác, người ác hiểm, người hung ác- (từ lóng) thằng bé tinh khôn quỷ quái!the demon of alcohol- ma men!the demon of jealousy- máu ghen!to be a demon for work- làm việc khoẻ như trâu!he is a demon centre forward- anh ta là một trung tâm quái kiệt
daemonic	/di:'mɔnik (daemonic) di:'mɔnik/*  tính từ- (như) demoniac- có tài xuất quỷ nhập thần
daff	/dɑ:f/*  ngoại động từ- (từ cổ,nghĩa cổ) gạt, bỏ
daffadowndilly	/'dæfədil (daffodilly) 'dæfədili (daffadowndilly) 'dæfədaun'dili/*  danh từ- (thực vật học) cây thuỷ tiên hoa vàng- màu vàng nhạt*  tính từ- vàng nhạt
daffodil	/'dæfədil (daffodilly) 'dæfədili (daffadowndilly) 'dæfədaun'dili/*  danh từ- (thực vật học) cây thuỷ tiên hoa vàng- màu vàng nhạt*  tính từ- vàng nhạt
daffodilly	/'dæfədil (daffodilly) 'dæfədili (daffadowndilly) 'dæfədaun'dili/*  danh từ- (thực vật học) cây thuỷ tiên hoa vàng- màu vàng nhạt*  tính từ- vàng nhạt
daffy	/'dɑ:fi/*  tính từ- (từ Mỹ,nghĩa Mỹ),  (thông tục) gàn, cám hấp
daft	/dɑ:ft/*  tính từ (Ớ-cốt)- ngớ ngẩn; mất trí; gàn, dở người=to go daft+ mất trí- nhẹ dạ, khinh suất, nông nổi
dagger	/'dægə/*  danh từ- dao găm- (ngành in) dấu chữ thập!to be at daggers drawm!to be at daggers' points- hục hặc với nhau; sẵn sàng choảng nhau!to look daggers at- nhìn giận dữ, nhìn hầm hầm; nhìn trừng trừng!to speak daggers to someone- nói cay độc với ai; nói nóng nảy với ai, gắt gỏng với ai
daggle	/'dægl/*  động từ- lội bùn- kéo lê trong bùn, quét trong bùn (vạt áo)
dago	/'deigou/*  danh từ- (từ Mỹ,nghĩa Mỹ) agô
daguerreotype	/də'geroutaip/*  danh từ- phép chụp hình đage
dahlia	/'deiljə/*  danh từ- (thực vật học) cây thược dược!blue dahlia- (thông tục) điều không thể có được; vật không thể có được
daily	/'deili/*  tính từ & phó từ- hằng ngày=one's daily bread+ miếng ăn hằng ngày=most newspapers appear daily+ hầu hết các báo đều xuất bản hằng ngày*  danh từ- báo hàng ngày- (thông tục) người đàn bà giúp việc hằng ngày đến nhà
daintiness	/'deintinis/*  danh từ- vị ngon lành- vẻ thanh nhã; vẻ xinh xắn- sự khó tính (trong cách ăn uống), sự kém ăn- vẻ chải chuốt cầu kỳ (trong cách ăn mặc); tính thích sang trọng
dainty	/'deinti/*  tính từ- ngon, chọn lọc (món ăn)=a dainty morsel+ miếng ăn ngon- thanh nhã; xinh xắn; dễ thương=a dainty foot+ bàn chân xinh xắn=a dainty girl+ cô gái xinh xắn dễ thương- khó tính (trong cách ăn uống), khảnh ăn, kén ăn- chải chuốt cầu kỳ (trong cách ăn mặc); thích sang trọng, thích hoa mỹ!to be born with a dainty tooth- kén ăn, ăn uống khó tính
dairy	/'deəri/*  danh từ- nơi trữ và sản xuất bơ sữa- cửa hàng bơ sữa- trại sản suất bơ sữa- sự sản xuất bơ sữa- bầy bò sữa (trong trại sản xuất sữa)
dairy cattle	/'deəri'kætl/*  danh từ- bò sữa
dairy-farm	/'deərifɑ:m/*  danh từ- trại sản xuất bơ sữa
dairying	/'deəriiɳ/*  danh từ- sự sản xuất bơ sữa
dairymaid	/'deərimeid/*  danh từ- cô gái làm việc trong trại sản xuất bơ sữa- cô gái bán bơ sữa
dairyman	/'deərimən/*  danh từ- chủ trại sản xuất bơ sữa- người làm việc trong trại sản xuất bơ sữa- người bán bơ sữa
dais	/'deiis/*  danh từ- bệ, đài, bục
daisied	/'deizid/*  tính từ- đầy hoa cúc
daisy	/'deizi/*  danh từ- (thực vật học) cây cúc- người loại nhất, vật loại nhất; cái đẹp nhất!as fresh as a daisy- tươi như hoa!to turn up one's toes to the daisies- (từ lóng) chết, ngủ với giun
daisy-chain	/'deizitʃein/*  danh từ- vòng hoa cúc
daisy-cutter	/'deizi,kʌtə/*  danh từ (từ lóng)- ngựa chạy hầu như không nhấc cẳng lên- (thể dục,thể thao) quả bóng bay là mặt đất (crickê)
dale	/deil/*  (thơ ca)- thung lũng (miền bắc nước Anh)!up hill and down dale- (xem) hill!to curse up hill and down dale- chửi như hát hay, chửi ra chửi vào
dalesman	/'deilzmən/*  danh từ- người ở thung lũng (miền bắc nước Anh)
dalliance	/'dæliəns/*  danh từ- sự yêu đương lăng nhăng; sự ve vãn, sự chim chuột; sự suồng sã cợt nhã- sự đùa giỡn, sự coi như chuyện đùa (đối với ai, đối với công việc gì)- sự đà đẫn mất thì giờ; sự chơi bời nhảm nhí mất thời giờ; sự lần lữa; sự dây dưa- sự lẩn tránh
dally	/'dæli/*  nội động từ- ve vãm, chim chuột- đùa giỡn, coi như chuyện đùa- đà đẫn lãng phí thì giờ; lần lữa; dây dưa=to dally over one's work+ dây dưa trong công việc- (+ with) lẩn tránh (ai, việc gì)*  ngoại động từ- làm mất, bỏ phí=to dally away one's time+ bỏ phí thời gian=to dally away one's opportunity+ bỏ lỡ cơ hội
dalmatic	/dæl'mætik/*  danh từ- áo thụng xẻ tà (của giám mục; của vua chúa khi làm lễ lên ngôi)
daltonian	/dɔ:l'touniən/*  danh từ- (y học) mù màu
daltonism	/'dɔ:ltənizm/*  danh từ- (y học) chứng mù màu
dam	/dæm/*  danh từ- (động vật học) vật mẹ!the devil and his dam- ma quỷ*  danh từ- đập (ngăn nước)- nước ngăn lại, bể nước*  ngoại động từ- xây đập (ở nơi nào); ngăn (nước) bằng đập- (nghĩa bóng) ((thường) + up) ghìm lại, kiềm chế lại=to dam up one's emotion+ kiềm chế nỗi xúc động
damage	/'dæmidʤ/*  danh từ- mối hại, điều hại, điều bất lợi- sự thiệt hại=to cause great damage to...+ gây nhiều thiệt hại cho...- (số nhiều) tiền bồi thường thiệt hại; tiền bồi thường tai nạn=to bring an action of damages against somebody+ kiện ai đòi bồi thường thiệt hại- (từ lóng) giá tiền=what's the damage?+ giá bao nhiêu?*  ngoại động từ+ (endamage) /in'dæmidʤ/- làm hư hại, làm hỏng, gây thiệt hại, gây tổn hại- làm hại (ai); làm tổn thương (danh dự...)=to damage someone's reputation+ làm tổn thương danh dự của ai
damage control	/'dæmidʤkən'troul/*  danh từ- (kỹ thuật) công việc sửa chữa từng bộ phận (máy)
damageable	/'dæmidʤəbl/*  tính từ- có thể bị hư hại, có thể bị hư hỏng
damaging	/'dæmidʤiɳ/*  tính từ- hại, có hại, gây thiệt hại
daman	/'dæmən/*  danh từ- (động vật học) con đaman
damascene	/,dæmə'si:n/*  ngoại động từ- nạm vàng, nạm bạc (vào kim loại)
damask	/'dæməsk/*  danh từ- tơ lụa Đa-mát; gấm vóc Đa-mát- thép hoa Đa-mát- hoa hồng Đa-mát- màu đỏ tươi*  tính từ- dệt hoa, thêu hoa (như gấm vóc Đa-mát)- làm bằng thép hoa Đa-mát- đỏ tươi*  ngoại động từ- dệt hoa, thêu hoa (vào vải, ... như gấm vóc Đa-mát)- (như) damascene- bôi đỏ (má...)
dame	/deim/*  danh từ- phu nhân (bá tước, nam tước...)- viên quản lý nhà ký túc trường I-tơn (Anh)- (từ cổ,nghĩa cổ) bà; người đàn bà đứng tuổi
dame-school	/'deimsku:l/*  danh từ- trường tiểu học (giống như loại ngày xưa do các bà đứng tuổi làm hiệu trưởng)
damn	/dæm/*  danh từ- lời nguyền rủa, lời chửi rủa- chút, tí, ít!I don't care a damn- (xem) care!not worth a damn- chẳng đáng nửa đồng, chẳng đáng một trinh*  ngoại động từ- chê trách, chỉ trích; kết tội=to damn someone's character+ chỉ trích tính nết của ai=to damn with feint praise+ làm bộ khen để chỉ trích chê bai- chê, la ó (một vở kịch)- làm hại, làn nguy hại; làm thất bại- đày địa ngục, bắt chịu hình phạt đời đời, đoạ đày- nguyền rủa, chửi rủa=I'll be damned if I know+ tớ mà biết thì tớ cứ chết (thề)=damn him!+ thằng khốn kiếp!, thằng chết tiệt, quỷ tha ma bắt nó đi!=damn it!; damn your!; damn your eyesdamn+ đồ trời đánh thánh vật!, quỷ tha ma bắt mày đi!, đồ khốn kiếp!=damn your impudence!+ liệu hồn cái đồ xấc láo!*  nội động từ- nguyền rủa, chửi rủa
e	/'iədrɔps/*  danh từ- thuốc nhỏ tai
e'en	/i:n/*  phó từ- (thơ ca) (như) even
e'er	/'eə/*  phó từ- (thơ ca) (như) ever
e-boat	/'i:bout/*  danh từ- tàu phóng ngư lôi của địch
e.g	/ig'zempli'greiʃiə/*  phó từ- thí dụ ((viết tắt) e.g)
each	/i:tʃ/*  tính từ- mỗi=each day+ mỗi ngày*  danh từ- mỗi người, mỗi vật, mỗi cái=each of us+ mỗi người chúng ta!each and all- tất cả mọi người, ai ai!each other- nhau, lẫn nhau=to love each other+ yêu nhau
eager	/'i:gə/*  tính từ- ham, háo hức, hăm hở, thiết tha, hau háu=eager for learning+ ham học=eager for gain+ hám lợi=eager glance+ cái nhìn hau háu=eager hopes+ những hy vọng thiết tha- nồng (rượu...)- (từ cổ,nghĩa cổ) rét ngọt
eagerness	/'i:gənis/*  danh từ- sự ham, sự háo hức, sự hâm hở, sự thiết tha, sự say mê; tính hám
eagle	/'i:gl/*  danh từ- (động vật học) chim đại bàng- hình đại bàng (ở huy hiệu, bục giảng kinh, quốc huy Mỹ...)- (từ Mỹ,nghĩa Mỹ) đồng 10 đô la vàng=double eagle+ đồng 20 đô la vàng*  định ngữ- như đại bàng, như diều hâu=eagle nose+ mũi khoằm, mũi diều hâu
eagle-eyed	/'i:gl'aid/*  tính từ- có mắt diều hâu, tinh mắt
eaglet	/'i:glit/*  danh từ- (động vật học) đại bàng con
eagre	/'eigə/*  danh từ- triều dâng
ear	/iə/*  danh từ- tai=to pick up (to cock) one's ears+ vểnh tai lên (để nghe)- vật hình tai (quai, bình đựng nước...)- tai (bông), sự nghe, khả năng nghe=to have (keep) a sensitive ear; to have sharp ears+ thính tai=a fine ear for music+ tai sành nhạc!to be all ears- lắng tai nghe!to be over head and ears in; to be head over in- (xem) head!to bring hornet' nest about one's ears- (xem) hornet!to get someone up on his ears- (từ Mỹ,nghĩa Mỹ),  (thông tục) làm ai phật ý, làm ai nổi cáu!to give (lend an) ear to- lắng nghe!to give someone a thick ear- cho ai một cái bạt tai!to go in at one ear and out at the other- vào tai này ra tai kia!to have (gain) someone's ear- được ai sẵn sàng lắng nghe!to keep one's ear open for- sẵn sàng nghe!to send somebody away a flen in his ear- làm cho ai tiu nghỉu (vì từ chối cái gì, vì khiển trách)!to set by the ears- (xem) set!to turn a sympathetic (ready) ear to someone's request- lắng nghe lời yêu cầu của ai với thái độ thiện cảm!walls have ears- tai vách mạch dừng!a word in someone's ears- lời rỉ tai ai!would give one's ears for something (to get something)- (xem) give*  danh từ- bông (lúa...)=rice in the ear+ lúa trổ (bông)*  nội động từ- trổ bông (lúa...)
ear-ache	/'iəreik/*  danh từ- sự đau tai; bệnh đau tai
ear-drop	/'iədrɔp (ear-ring) 'iəriɳ/-ring) /'iəriɳ/*  danh từ- hoa tai
ear-drops	/'iədrɔps/*  danh từ- thuốc nhỏ tai
ear-drum	/'iədrʌm/*  danh từ- (giải phẫu) màng tai
ear-hole	/'iəhoul/*  danh từ- lỗ tai
ear-phone	/'iəfoun/*  danh từ- ống nghe
ear-pick	/'iəpik/*  danh từ- cái lấy ráy tai
ear-ring	/'iədrɔp (ear-ring) 'iəriɳ/-ring) /'iəriɳ/*  danh từ- hoa tai
ear-splitting	/'iə,splitiɳ/*  tính từ- điếc tai, inh tai, chối tai (tiếng động...)
ear-tab	/'iətæb/*  danh từ- cái che tai (ở mũ)
ear-trumpet	/'iə,trʌmpit/*  danh từ- ống nghe (của người nghễnh ngãng)
ear-wax	/'iəwæks/*  danh từ- ráy tai
earing	/'iəriɳ/*  danh từ- (hàng hải) dây tai (dùng để buộc góc buồm trên vào cột buồm)
earl	/ə:l/*  danh từ- bá tước (ở Anh) ((xem) count)
earldom	/'ə:ldəm/*  danh từ- lãnh địa bá tước, đất bá tước- tước bá
earless	/'iəlis/*  tính từ- không có tai- không có quai (bình đựng nước...)- không có tai nhạc
earliness	/'ə:linis/*  danh từ- lúc sớm sủa- sự chín sớm (hoa quả); sự đến sớm (mùa, sự chết...)
early	/'ə:li/*  tính từ- sớm, ban đầu, đầu mùa=an early riser+ người hay dậy sớm=early prunes+ mận sớm, mận đầu mùa- gần đây=at an early date+ vào một ngày gần đây*  phó từ- sớm, ở lúc ban đầu, ở đầu mùa=to rise early+ dậy sớm=early in the morning+ vào lúc sáng sớm!early enough- vừa đúng lúc!earlier on- trước đây!early in the list- ở đầu danh sách!as early as the 19th century- ngay từ thế kỷ 19!they got up a bit early for you- (thông tục) chúng láu cá hơn anh, chúng ta đã lừa được anh rồi
early bird	/'ə:libə:d/*  danh từ-(đùa cợt) người hay dậy sớm, người chưa bảnh mắt đã dậy
earmark	/'iəmɑ:k/*  danh từ- dấu đánh ở tai (cừu...)- dấu riêng (để chỉ sự sở hữu...)*  ngoại động từ- đánh dấu ở tai (cừu...)- đánh dấu riêng (để chỉ sự sở hữu...)- dành (khoản chi tiêu...)
earmuffs	/'iəmʌfs/*  danh từ số nhiều- mũ (bằng len, dạ...) che tai (cho khỏi rét)
earn	/ə:n/*  ngoại động từ- kiếm được (tiền...); giành được (phần thưởng, sự khen ngợi...)=to earn one's living+ kiếm sống
earnest	/'ə:nist/*  tính từ- đứng đắn, nghiêm chỉnh- sốt sắng, tha thiết*  danh từ- thái độ đứng đắn, thái độ nghiêm chỉnh=in earnest+ đứng đắn, nghiêm chỉnh=are you in earnest?+ anh không đùa đấy chứ?=you are not in earnest+ anh lại đùa đấy thôi!it is raining in earnest- trời đang mưa ra trò*  danh từ- tiền đặt cọc- sự bảo đảm- điềm, điều báo hiệu trước=an earnest of future success+ điều báo hiệu cho sự thành công sau này
earnestness	/'ə:nistnis/*  danh từ- tính đứng đắn, tính nghiêm chỉnh- tính sốt sắng, tính tha thiết
earnings	/'ə:niɳz/*  danh từ số nhiều- tiền kiếm được, tiền lương- tiền lãi
earser	/i'reizə/*  danh từ- người xoá, người xoá bỏ- cái tẩy, cái cạo- giẻ lau bảng
earshot	/'iəriɳ/*  danh từ- tầm nghe=within earshot+ trong tầm nghe=out oaf earshot+ ngoài tầm nghe
earsure	/i'reiʤə/*  danh từ- sự xoá, sự xoá bỏ- vết xoá, vết cạo
earth	/ə:θ/*  danh từ- đất, đất liền, mặt đất (đối lại với trời); quả đất- (hoá học) đất=rare earths+ đất hiếm- hang (cáo, chồn...)=to go to earth+ chui vào tận hang- trần gian, cõi tục (đối với thiên đường, địa ngục)!to come back to earth- thôi mơ tưởng mà trở về thực tế!to move heaven and earth- (xem) move*  ngoại động từ- vun (cây); lấp đất (hạt giống)- đuổi (cáo...) vào hang*  nội động từ- chạy vào hang (cáo...)- điện đặt dây đất, nối với đất
earth-bed	/'ə:θbed/*  danh từ- luống đất (để gieo trồng)- mộ, mồ, mả
earth-born	/'ə:θbɔ:n/*  tính từ- trần tục- (thần thoại,thần học) sinh ra từ đất
earth-bound	/'ə:θbaund/*  tính từ- bị giới hạn bởi đất, có đất bao quanh- hướng về phía đất; đi về phía đất
earth-flax	/'ə:θflæks/*  danh từ- (khoáng chất) Amiăng, thạch miên
earth-light	/'ə:θʃain (earth-light) 'ə:θlait/-light) /'ə:θlait/*  danh từ- (thiên văn học) ánh đất (sự chiếu sáng phần tối của mặt trăng do ánh sáng từ đất ánh lên)
earth-nut	/'ə:θnʌt/*  danh từ (thực vật học)- nấm cục, nấm tơruyp- lạc; cây lạc=earth-nut oil+ dầu lạc
earth-shine	/'ə:θʃain (earth-light) 'ə:θlait/-light) /'ə:θlait/*  danh từ- (thiên văn học) ánh đất (sự chiếu sáng phần tối của mặt trăng do ánh sáng từ đất ánh lên)
earth-worm	/'ə:θwə:m/*  danh từ- giun đất- (nghĩa bóng) người quỵ luỵ, người khúm núm
earthen	/'ə:θən/*  tính từ- bằng đất, bằng đất nung
earthenware	/'ə:θənweə/*  danh từ- đồ bằng đất nung (nồi, niêu, chậu, vò...)- đất nung (làm nồi...)- (định ngữ) bằng đất nung
earthiness	/'ə:θlinis/*  danh từ- tính chất như đất; tính chất bằng đất, tính trần tục
earthliness	/'ə:θlinis/*  danh từ- tính trần tục
earthling	/'ə:θliɳ/*  danh từ- con người (sống ở trái đất)- người phàm tục, người trần tục
earthly	/'ə:θli/*  tính từ- (thuộc) quả đất- trần tục- (thông tục) có thể, có thể tưởng tượng được=no earthly reason+ chả có chút lý do nào=no earthly use+ không có chút tác dụng nào!not an earthly- (từ lóng) đừng hòng thành công
earthquake	/'ə:θkweik/*  danh từ- sự động đất- (nghĩa bóng) sự chấn động (xã hội...)
earthward	/'ə:θwəd (earthwards) 'ə:θwədz/*  tính từ & phó từ- về phía trái đất
earthwards	/'ə:θwəd (earthwards) 'ə:θwədz/*  tính từ & phó từ- về phía trái đất
earthwork	/'ə:θwə:k/*  danh từ- công việc đào đắp- công sự đào đắp bằng đất
earthy	/'ə:θi/*  tính từ- như đất; bằng đất- (nghĩa bóng) trần tục, phàm tục
earwig	/'iəwig/*  danh từ- (động vật học) con xâu tai (sâu bọ)*  ngoại động từ- vận động ngần, vận động riêng (bằng lời nói); rỉ tai (ai)
ease	/i:z/*  danh từ- sự thanh thản, sự thoải mái; sự không bị ràng buộc=to be at one's ease+ được thoải mái, tinh thần thanh thản=to stand at ease+ đứng ở tư thế nghỉ- sự thanh nhàn, sự nhàn hạ=to write at ease+ viết lách trong lúc nhàn hạ- sự dễ dàng, dự thanh thoát=to write with ease+ viết văn dễ dàng- sự dễ chịu; sự không bị đau đớn; sự khỏi đau*  ngoại động từ- làm thanh thản, làm yên tâm- làm dễ chịu, làm đỡ đau, làm khỏi đau- làm bớt căng; (hàng hải) mở, nới=to ease a tense stituation+ làm tình hình bớt căng thẳng-(đùa cợt) nắng nhẹ=to be eased of one's wallet+ bị nẫng nhẹ mất ví tiền*  nội động từ- trở nên bớt căng (tình hinh...)- (+ of) trở nên bớt nặng nhọc; chùn, nhụt (sự cố gắng...)!ear her!- (hàng hải) giảm tốc độ máy đi!, chầm chậm thôi!
easeful	/'i:zful/*  tính từ- thanh thản, thoải mái- làm dịu- tha thẩn
easel	/'i:zl/*  danh từ- giá vẽ (của hoạ sĩ); giá bảng đen
easeless	/'i:zlis/*  tính từ- không thoải mái- không thể làm dịu được
easement	/'i:zmənt/*  danh từ- (pháp lý) quyền đi qua; quyền xây cất (trên đất người khác)- nhà phụ, công trình kiến trúc phụ- (từ cổ,nghĩa cổ) sự làm dịu (đau...)
easily	/'i:zili (easy) 'i:zi/*  phó từ- thoải mái, thanh thản, không lo lắng; thanh thoát, ung dung- dễ, dễ dàng!easy!- hãy từ từ!!easy all!- hãy ngừng tay! (chèo)!easy come easy go- (xem) come!stand easy!- (xem) stand!take it easy!- (thông tục) cứ ung dung mà làm!, cứ bình tĩnh!, cứ yên trí!
easiness	/'i:zinis/*  danh từ- sự thoải mái, sự thanh thản, sự không lo lắng; sự thanh thoát, sự ung dung- sự dễ dàng- tính dễ dãi, tính dễ thuyết phục
easing	/'i:ziɳ/*  danh từ- sự làm bớt đau, sự làm giảm đau- sự bớt căng thẳng (tình hình)
east	/i:st/*  danh từ- hướng đông, phương đông, phía đông=to the east of+ về phía đông của- miền đông- gió đông!Far East- Viễn đông!Middle East- Trung đông!Near East- Cận đông!East or West, home is best- dù cho đi khắp bốn phương, về nhà mới thấy quê hương đâu bằng*  tính từ- đông=east wind+ gió đông*  phó từ- về hướng đông; ở phía đông
east end	/'i:st'end/*  danh từ- khu đông Luân-đôn
east side	/'i:st'said/*  danh từ- khu đông Nữu-ước
east-ender	/'i:st'endə/*  danh từ- người dân khu đông Luân-đôn
easter	/'i:stə/*  danh từ- lễ Phục sinh=easter eggs+ trứng Phục sinh (trứng tô màu để tặng bạn bè vào dịp lễ Phục sinh)=easter offerings+ tiền lễ Phục sinh (cúng nhà thờ vào dịp lễ Phục sinh)
easterly	/'i:stəli/*  tính từ- đông=easterly wind+ gió đông*  phó từ- về hướng đông; từ hướng đông
eastern	/'i:stən/*  tính từ- đông*  danh từ- người miền đông ((cũng) easterner)- (tôn giáo) tín đồ nhà thờ chính thống
easterner	/'i:stənə/*  danh từ- người miền đông ((cũng) eastern)- Easterner dân các bang miền đông nước Mỹ
easternmost	/'i:stənmoust/*  tính từ- cực đông
easting	/'i:stiɳ/*  danh từ- (hàng hải) chặng đường đi về phía đông- hướng đông
eastward	/'i:stwəd/*  danh từ- hướng đông*  tính từ & phó từ- về phía đông
eastwardly	/'i:stwədli/*  tính từ- đông=eastwardly wind+ gió đông*  phó từ- về hướng đông, từ hướng đông
eastwards	/'i:stwədz/*  phó từ- về phía đông ((cũng) eastward)
easy	/'i:zi/*  tính từ- thoải mái, thanh thản, không lo lắng; thanh thoát, ung dung=easy manners+ cử chỉ ung dung- dễ, dễ dàng=easy of access+ dễ gần; dễ đi đến=easy money+ tiền kiếm được dễ dàng- dễ dãi, dễ tính; dễ thuyết phục- (thương nghiệp) ít người mua, ế ẩm!easy circumstances- sự sung túc, cuộc sống phong lưu!easy of virture- lẳng lơ (đàn bà)!to easy street- (từ Mỹ,nghĩa Mỹ) sung túc, phong lưu*  phó từ- (như) easily*  danh từ- sự nghỉ ngơi một lát=to have on easy+ nghỉ ngơi một lát
f	/ef/*  danh từ,  số nhiều F's- f- (âm nhạc) Fa
f.o.	/ef'ou/*  (viết tắt) của Foreign Office bộ ngoại giao Anh
fa	/fɑ: (fah) fɑ:/*  danh từ- (âm nhạc) Fa
fabian	/'feibjən/*  tính từ- trì hoãn, kéo dài=fabian policy+ chính sách trì hoãn, chính sách kéo dài- Fa-biên, theo thuyết Fa-biên=fabian Society+ hội Fa-biên (nhóm Xã hội chủ trương cải cách từ từ ở Anh)*  danh từ- (Fabian) người theo thuyết Fa-biên
fable	/'feibl/*  danh từ- truyện ngụ ngôn- truyền thuyết- (số nhiều) truyện hoang đường; truyện cổ tích- (số nhiều) chuyện phiếm, chuyện tán gẫu=old wives' fables+ chuyện ngồi lê đôi mách- lời nói dối, lời nói sai- cốt, tình tiết (kịch)*  nội động từ- nói bịa- (từ cổ,nghĩa cổ); (thơ ca) kể truyện hoang đường, hư cấu, thêu dệt*  ngoại động từ- hư cấu
fabled	/'feibld/*  tính từ- được kể trong ngụ ngôn; (thuộc) truyền thuyết, hoang đường- hư cấu, bịa đặt
fabler	/'feiblə/*  danh từ- nhà viết truyện ngụ ngôn, nhà thơ ngụ ngôn- người hay kể truyện hoang đường
fabric	/'fæbrik/*  danh từ- công trình xây dựng- giàn khung, kết cấu, cơ cấu ((nghĩa đen) & (nghĩa bóng))=the whole fabric of society+ toàn bộ cơ cấu xã hội=the fabric of arguments+ kết cấu của lý lẽ- vải ((thường) texile fabric)=silk and woollen fabrics+ hàng tơ lụa và len dạ- mặt, thớ (vải)
fabricant	/'fæbrikənt/*  danh từ- (từ Mỹ,nghĩa Mỹ) người chế tạo, người xây dựng
fabricate	/'fæbrikeit/*  ngoại động từ- bịa đặt (sự kiện)- làm giả (giấy tờ, văn kiện)- (từ hiếm,nghĩa hiếm) làm, chế tạo, sản xuất, xây dựng
fabricated	/'fæbrikeitid'haus/*  danh từ- nhà đúc sãn
fabrication	/,fæbri'keiʃn/*  danh từ- sự bịa đặt; chuyện bịa đặt- sự làm giả (giấy tờ, văn kiện)- sự chế tạo, sự sản xuất; cách chế tạo
fabricator	/'fæbrikeitə/*  danh từ- người bịa đặt- người làm giả (giấy tờ, văn kiện)- người chế tạo, người sản xuất
fabulist	/'fæbjulist/*  danh từ- nhà thơ ngụ ngôn, người viết truyện ngụ ngôn- người nói dối
fabulosity	/'fæbjuləsnis (fabulosity) ,fæbju'lɔsiti/*  danh từ- tính thần thoại, tính bịa đặt, tính hoang đường- tính ngoa ngoắt, tính khó tin
facade	/fə:sɑ:d/*  danh từ- mặt chính (nhà)- bề ngoài vẻ ngoài, mã ngoài
face	/feis/*  danh từ- mặt=to look somebody in the face+ nhìn thẳng vào mặt ai=to show one's face+ xuất đầu lộ diện, vác mặt đến=her face is her fortune+ cô ta đẹp nhưng nghèo; tất cả vốn liếng cô ta là ở bộ mặt- vẻ mặt=to pull (wear) a long face+ mặt buồn thườn thượt, mặt dài ra- thể diện, sĩ diện=to save one's face+ gỡ thể diện, giữ thể diện=to lose face+ mất mặt, mất thể diện- bộ mặt, bề ngoài, mã ngoài=to put a new face on something+ thay đổi bộ mặt của cái gì, đưa cái gì ra dưới một bộ mặt mới=on the face of it+ cứ theo bề ngoài mà xét thì=to put a good face on a matter+ tô son điểm phấn cho một vấn đề; vui vẻ chịu đựng một việc gì=to put a bold face on something+ can đảm chịu đựng (đương đầu với) cái gì- bề mặt=the face of the earth+ bề mặt của trái đất- mặt trước, mặt phía trước!face to face- đối diện!to fly in the face of- ra mặt chống đối, công khai chống đối!to go with wind in one's face- đi ngược gió!to have the face to do something- mặt dạn mày dày mà làm việc gì, có đủ trơ trẽn mà làm việc gì!in face of- trước mặt, đứng trước!in the face of- mặc dầu!in the face of day- một cách công khai!to make (pull) faces- nhăn mặt!to set one's face against- chống đối lại!to somebody's face- công khai trước mặt ai*  ngoại động từ- đương đầu, đối phó=to face up to+ đương đầu với- đứng trước mặt, ở trước mặt=the problem that faces us+ vấn đề trước mắt chúng ta- lật (quân bài)- nhìn về, hướng về, quay về=this house faces south+ nhà này quay về hướng nam- đối diện=to face page 20+ đối diện trang 20- (thể dục,thể thao) đặt ((nghĩa bóng)) ở giữa hai cầu thủ của hai bên (để bắt đầu thi đấu bóng gậy cong trên băng)- (quân sự) ra lệnh quay=to face one's men about+ ra lệnh cho quân quay ra đằng sau- viền màu (cổ áo, cửa tay)- bọc, phủ, tráng- hồ (chè)*  nội động từ- (quân sự) quay=left face!+ quay bên trái!=about face!+ quay đằng sau!!to face out a situatin- vượt qua một tình thế!to face out something- làm xong xuôi cái gì đến cùng
face value	/'feis'vælju:/*  danh từ- giá trị danh nghĩa (của giấy bạc...)- (nghĩa bóng) giá trị bề ngoài=to accept (take) something at its face_value+ thừa nhận cái giá trị bề ngoài của nó
face-ache	/'feiseik/*  danh từ- đau dây thần kinh đầu
face-card	/'feiskɑ:d/*  danh từ- lá bài hình (quân K; quân Q; quân J)
face-guard	/'feisgɑ:d/*  danh từ- (thể dục,thể thao) lưới che mặt
face-lift	/'feislift/*  ngoại động từ- sửa mặt (ai) cho đẹp
face-lifting	/'feis,liftiɳ/*  danh từ- phẫu thuật, sửa đẹp mặt (làm bớt vết nhăn)
facer	/'feisə/*  danh từ- cú đấm vào mặt- khó khăn đột xuất
facet	/'fæsit/*  danh từ- mặt (kim cương...)- mặt khía cạnh (vấn đề...)
faceted	/'fæsitid/*  danh từ- có nhiều mặt (kim cương...)
facetiae	/fə'si:ʃii:/*  danh từ số nhiều- những câu khôi hài, những câu hài hước, những câu dí dỏm, những câu bông lơn- sách tiếu lâm
facetious	/fə:si:ʃəs/*  tính từ- hay khôi hài, hay hài hước, hay bông lơn
facetiousness	/fə:si:ʃəsnis/*  danh từ- tính khôi hài, tính hài hước, tính bông lơn
facia	/'feiʃə/*  danh từ- biển tên (đề tên chủ hiệu, đóng trước cửa hàng)
facial	/'feiʃəl/*  tính từ- (thuộc) mặt=facial artery+ (giải phẫu) động mạch mặt=facial angle+ góc mặt*  danh từ- sự xoa bóp mặt
facile	/'fæsail/*  tính từ- dễ, dễ dàng; thông, trôi chảy- sãn sàng; nhanh nhảu- dễ dãi, dễ tính; hiền lành
facilitate	/fə'siliteit/*  ngoại động từ- làm cho dễ dàng; làm cho thuận tiện
gear	/giə/*  danh từ- cơ cấu, thiết bị, dụng cụ; đồ gá lắp, phụ tùng- (kỹ thuật) bánh răng; sự truyền động bánh răng; số (ô tô...)=to go into first gear+ mở số một=to change gear+ sang số (ô tô...)=in gear+ khớp bánh răng; gài số=out of gear+ không khớp bánh răng; không gài số- (hàng hải) thiết bị tàu thuỷ- bộ yên cương ngựa- đồ dùng, đồ đạc=all one's worldly gear+ tất cả những cái mà người ta có; tất cả của cải*  ngoại động từ- sang số (ô tô...)=to gear up+ lên số=to gear down+ xuống số- lắp bánh (nhà máy, một ngành công nghiệp...) phục vụ (một nhà máy khác, một ngành khác, kế hoạch...)=to gear agriculture to socialist construction+ hướng công nghiệp phục vụ công cuộc xây dựng xã hội chủ nghĩa*  nội động từ- ăn khớp vào nhau (bánh răng)!to gear up production- đẩy mạnh sản xuất
gear-box	/'giəbɔks (gear-case) 'giəkeis/-case) /'giəkeis/*  danh từ- hộp số (ô tô)
gear-case	/'giəbɔks (gear-case) 'giəkeis/-case) /'giəkeis/*  danh từ- hộp số (ô tô)
gear-ratio	/'giə'reiʃiou/*  danh từ- (kỹ thuật) số truyền động
gear-wheel	/'giəwi:l/*  danh từ- bánh răng
gearing	/'giəriɳ/*  danh từ- (kỹ thuật) hệ thống bánh răng (máy)- (kỹ thuật) sự ăn khớp (các bánh răng); sự truyền động bánh răng
gecko	/'gekou/*  danh từ- (động vật học) con tắc kè
gee	/dʤi:/*  danh từ+ (gee-gee) /'dʤi:dʤi:/- khuấy thán từ- đi nào (tiếng quát ngựa) ((cũng) gee-ho,  gee-hup,  gee-up,  gee-wo)- (từ Mỹ,nghĩa Mỹ) cứ thế!, thế!, được!
gee-gee	/dʤi:/*  danh từ+ (gee-gee) /'dʤi:dʤi:/- khuấy thán từ- đi nào (tiếng quát ngựa) ((cũng) gee-ho,  gee-hup,  gee-up,  gee-wo)- (từ Mỹ,nghĩa Mỹ) cứ thế!, thế!, được!
geese	/gu:s/*  danh từ,  số nhiều geese- (động vật học) ngỗng, ngỗng cái- thịt ngỗng- người ngốc nghếch, người khờ dại!all his geese are swans- (xem) swan!can't say bo to a goose- (xem) bo!to cook that lays the golden eggs- tham lợi trước mắt*  danh từ,  số nhiều gooses- bàn là cổ ngỗng (của thợ may)
geezer	/'gi:zə/*  danh từ- (từ lóng) ông già, bà già
geiger counter	/'gaigə'kauntə/*  danh từ- (vật lý) máy đếm Ghai-ghe
geisha	/'geiʃə/*  danh từ- vũ nữ Nhật
gel	/dʤel/*  danh từ- (hoá học) chất gien
gelatin	/,dʤelə'ti:n (gelatine) ,dʤelə'ti:n/*  danh từ- Gelatin!blasting gelatine- chất nổ nitroglyxerin
gelatine	/,dʤelə'ti:n (gelatine) ,dʤelə'ti:n/*  danh từ- Gelatin!blasting gelatine- chất nổ nitroglyxerin
gelatinize	/dʤi'lætinaiz/*  ngoại động từ- nấu thành gelatin, làm thành gelatin*  nội động từ- thành gelatin
gelatinous	/dʤi'lætinəs/*  tính từ- (thuộc) gelatin- sền sệt
gelation	/dʤi'leiʃn/*  danh từ- sự đông lại, sự đặc lại (vì lạnh)
geld	/geld/*  ngoại động từ gelded,  gelt- thiến (súc vật)
gelder	/'geldə/*  danh từ- người thiến (súc vật)
gelding	/'geldiɳ/*  danh từ- sự thiến- ngựa thiến, súc vật thiến
gelid	/'dʤelid/*  tính từ- rét buốt, giá lạnh- (nghĩa bóng) lạnh lùng, nhạt nhẽo, thờ ơ (gióng nói, thái độ)
gelignite	/'dʤelignait/*  danh từ- Gêlinhit (một loại chất nổ)
gelt	/geld/*  ngoại động từ gelded,  gelt- thiến (súc vật)
gem	/dʤem/*  danh từ- viên ngọc- đá chạm, ngọc chạm- (nghĩa bóng) vật quý nhất=the gem of the whole collection+ cái quý nhất trong toàn bộ sưu tập- (từ Mỹ,nghĩa Mỹ) bánh bơ nhạt*  nội động từ- dát ngọc=the night sky gemmed with stars+ bầu trời đêm nay đầy sao như dát ngọc
geminate	/'dʤeminit - 'dʤemineit/- 'dʤemineit/*  tính từ- (sinh vật học) từng cặp, từng đôi*  ngoại động từ- (sinh vật học) sắp thành cặp, sắp thành đôi
gemination	/,dʤemi'neiʃn/*  danh từ (sinh vật học)- sự sắp thành đôi
gemma	/'dʤemə/*  danh từ,  số nhiều gemmae- (sinh vật học) mầm
gemmae	/'dʤemə/*  danh từ,  số nhiều gemmae- (sinh vật học) mầm
gemmate	/'dʤemeit/*  tính từ- (sinh vật học) có mầm- sinh sản bằng mầm*  nội động từ- mọc mầm, đâm chồi- sinh sản bằng mầm
gemmation	/dʤe'meiʃn/*  danh từ- (sinh vật học) sự mọc mầm; sự sinh mầm- sự sinh sản bằng mầm
gemmiferous	/dʤe'mifərəs/*  tính từ- có ngọc- có mầm
gemmiparous	/dʤe'mipərəs/*  tính từ (sinh vật học)- sinh mầm- sinh sản bằng mầm
gemmule	/'dʤemju:l/*  danh từ- (thực vật học) sinh mầm
gen	/dʤen/*  danh từ (quân sự),  (từ lóng)- (viết tắt) của general information- bản tin (phát cho tất cả sĩ quan các cấp trước khi bước vào chiến dịch)
gendarme	/'ʤỴ:ndɑ:m/*  danh từ- sen đầm
gendarmerie	/'ʤỴ:ndɑ:məri/*  danh từ- đội sen đầm
gender	/'dʤendə/*  danh từ- (ngôn ngữ học) giống=masculine gender+ giống đực=feminine gender+ giống cái*  ngoại động từ- (thơ ca) (như) engender
gene	/dʤi:n/*  danh từ- (sinh vật học) Gen
genealogical	/,dʤi:njə'lɔdʤikəl/*  tính từ- (thuộc) phả hệ=a genealogical tree+ cây phả hệ
genealogist	/,dʤi:ni'ælədʤist/*  danh từ- nhà phả hệ học- người lập bảng phả hệ
genealogy	/,dʤi:ni'ælədʤi/*  danh từ- khoa phả hệ (của con người, các sinh vật, ngôn ngữ...)- bảng phả hệ
genera	/'dʤi:nəs/*  danh từ,  số nhiều genera- (sinh vật học) phái, giống- loại
general	/'dʤenərəl/*  tính từ- chung, chung chung=a matter of general interest+ một vấn đề có quan hệ đến lợi ích chung; một vấn đề được mọi người quan tâm=to work for general welfare+ làm việc vì phúc lợi chung=general opinion+ ý kiến chung=general knowledge+ kiến thức chung, kiến thức phổ thông- tổng=a general election+ cuộc tổng tuyển cử=a general strike+ cuộc tổng bãi công=inspector general+ tổng thanh tra!General Headquaters- (quân sự) tổng hành dinh!General Staff- (quân sự) bộ tổng tham mưu- thường=a word that is in general use+ một từ thường dùng=as a general rule+ theo lệ thường=in general+ thông thường; đại khái, đại thể!general dealer- người bán bách hoá!general hospital- bệnh viện đa khoa!general practitioner- bác sĩ đa khoa!general reader- người đọc đủ các loại sách!general servant- người hầu đủ mọi việc*  danh từ- cái chung, cái đại thể, cái tổng quát, toàn thể=to argue from the general to the particular+ suy tư cái chung ra cái riêng=the general of mankind+ toàn thể loài người- (quân sự) tướng, nhà chiến lược xuất sắc; nhà chiến thuật xuất sắc- (the general) (từ cổ,nghĩa cổ) nhân dân quần chúng- (tôn giáo) trưởng tu viện- người hầu đủ mọi việc ((cũng) general vervant)
generalise	/'dʤenərəlaiz (generalise) 'dʤenərəlaiz/*  động từ- tổng quát hoá; khái quát hoá- phổ biến=to generalize a new farming technique+ phổ biến một kỹ thuật cày cấy mới- nói chung, nói chung chung
generalissimo	/,dʤenərə'lisimou/*  danh từ- (quân sự) tổng tư lệnh
generality	/,dʤenə'ræliti/*  danh từ- nguyên tắc chung chung; cái chung chung; tính tổng quát; tính đại cương!to come down from generalities to particulars- thôi nói chung chung mà đi vào chi tiết cụ thể- tính phổ biến=a rule of great generality+ một quy luật rất phổ biến- tính mập mờ- phần lớn, phần đông, đa số
generalization	/,dʤenərəlai'zeiʃn/*  danh từ- sự tổng quát hoá; sự tổng hợp, sự khái quát, sự suy rộng- điều tổng quát, điều khái quát
generalize	/'dʤenərəlaiz (generalise) 'dʤenərəlaiz/*  động từ- tổng quát hoá; khái quát hoá- phổ biến=to generalize a new farming technique+ phổ biến một kỹ thuật cày cấy mới- nói chung, nói chung chung
generalized	/'dʤenərəlaizd/*  tính từ- tổng quát hoá, suy rộng=generalized function+ (toán học) hàm suy rộng
generalizer	/'dʤenərəlaizə/*  danh từ- người tổng quát hoá; người khái quát hoá
generally	/'dʤenərəli/*  phó từ- nói chung, đại thể=generally speaking+ nói chung- thông thường, theo như lệ thường
generalship	/'dʤenərəlʃip/*  danh từ- (quân sự) cấp tướng- chiến lược, chiến thuật- tài chỉ huy quân sự- sự khéo léo; tài ngoại giao- tài quản lý, tài điều khiển
generate	/'dʤenəreit/*  ngoại động từ- sinh, đẻ ra- phát, phát ra=to generate electricity+ phát điện
generation	/,dʤenə'reiʃn/*  danh từ- sự sinh ra, sự phát sinh ra- thế hệ, đời- (điện học) sự phát điện
generative	/'dʤenərətiv/*  tính từ- có khả năng sinh ra, sinh ra
generator	/'dʤenəreitə/*  danh từ- người sinh ra, người tạo ra, cái sinh thành- máy sinh, máy phát; máy phát điện=an ultrasonic generator+ máy phát siêu âm
hypoparathyroidism	* danh từ- (y học) sự giảm năng tuyến cận giáp
hypopharynx	* danh từ; số nhiều hypopharynges,  hypopharynxes- hầu dưới
hypophyseal	* tính từ; cũng hypophysial- thuộc tuyến yên* tính từ; cũng hypophysial- thuộc tuyến yên
hypophysectomize	* ngoại động từ- cắt bỏ tuyến dưới
hypophysectomy	* danh từ- (y học) thủ thuật cắt bỏ tuyến yên
hypopituitarism	* danh từ- (y học) chứng giảm năng tuyến yên
hypoplasia	* danh từ- (y học) sự giảm sản
hypoplastic	* tính từ- thuộc giảm sản
hyposeal	* tính từ- thuộc tuyến yên
hypostoma	- xem hypostome+danh từ; số nhiều hypostomas,  hypostomata
hypostome	* danh từ- (động vật) tấm dưới miệng
hypostyle	* danh từ- adj- (có) cột đỡ trần
hypotatic	* tính từ- thuộc quan hệ cú pháp lệ thuộc
hypotaxis	* danh từ- (ngôn ngữ) quan hệ cú pháp lệ thuộc
hypothalamic	* tính từ- (y học) dưới đồi
hypothalamus	* danh từ (số nhiều hypothalami hoặc hypothalamai)- vùng não điều khiển thân nhiệt, đói, khát...
hypotheque	* danh từ- (pháp lý) quyền thế nợ bằng bất động sản, quyền cầm thế để đương
hypothermal	* tính từ- (thuộc) mạch thủy nhiệt sâu
hypothermic	* tính từ- thuộc sự giảm nhiệt một cách nguy hiểm (trong cơ thể)
hypothetical	- Cách viết khác : hypothetic 
hypothetically	* phó từ- theo giả thuyết
hypothyroid	* danh từ- xem hypothyroidism
hypothyroidism	* danh từ- sự giảm hoạt động của tuyến giáp
hypotonic	* tính từ- nhược trương
hypotonicity	* danh từ- sự nhược trương
hypoventilation	* danh từ- chứng thở quá chậm
hypoxia	* danh từ- (y học) sự giảm oxi-huyết
hypsographic(al)	* tính từ- (thuộc) sự giảm oxi-huyết
hypsometrical	- Cách viết khác : hypsometric 
hyrax	* danh từ; số nhiều hyraxes,  hyraces- (động vật) bộ đa man
hysterectomise	* ngoại động từ- cắt bỏ tử cung
hysterectomy	* danh từ- thủ thuật cắt bỏ dạ con, thủ thuật cắt bỏ tử cung
hysteric	* tính từ- thuộc ictêri; mặc chứng cuồng loạn- (thông tục) hết sức buồn cười; hết sức ngộ nghĩnh
hysterically	* phó từ- cuồng loạn, thác loạn
hysteroid	* tính từ- như cuồng loạn
i-spy	* danh từ- trò chơi đoán chữ của trẻ em
i.e	* (viết tắt)- tức là, nghĩa là (Id est)
i.o	/o/- hệ thống vào/ra
i.q	* (viết tắt)- cũng như (Idem quod)- chỉ số thông minh (intelligence quotient)
iac	- Mối liên kết trong System 7
iaea	* (viết tắt)- Cơ quan năng lượng nguyên tử quốc tế (International Atomic Energy Agency)- viết tắt- Cơ quan năng lượng nguyên tử quốc tế (International Atomic Energy Agency)
iata	* (viết tắt)- công ty chuyên chở hàng không quốc tế (International  Air Transport Association)
iatrogenic	* tính từ- (thuộc chứng bệnh) gây ra do khám bệnh hoặc điều trị
iba	* (viết tắt)- cơ quan phát thanh độc lập (Independent Broadcasting Authority)
ibexes	- xem ibex
ibid	* ngoại động từ- cùng ở cuốn sách đó hoặc đoạn đó v v...* ngoại động từ- cùng ở cuốn sách đó hoặc đoạn đó v v...
ible	- hậu tố- có hoặc tỏ rõ một phẩm chất nào đó; có thể hoặc phải là; có khuynh hướng= perceptible+có thể cảm nhận được= comprehensible+có thể hiểu được; dễ hiểu- hậu tố- có hoặc tỏ rõ một phẩm chất nào đó; có thể hoặc phải là; có khuynh hướng= perceptible+có thể cảm nhận được= comprehensible+có thể hiểu được; dễ hiểu
ibm	- vt của International Business Machines (Công ty máy điện toán IBM của Mỹ)
ibo	* danh từ- người da đen ở đông nam Nigiêria- ngôn ngữ của dân tộc này
ibrd	* (viết tắt)- ngân hàng quốc tế tái thiết và phát triển (International  Bank  for  Reconstruction  and  Development) (còn gọi là World Bank ngân hàng thế giới)- viết tắt- ngân hàng quốc tế tái thiết và phát triển (International  Bank  for  Reconstruction  and  Development) (còn gọi là World Bank ngân hàng thế giới)
ic	* (viết tắt)- mạch tổ hợp (International  Circuit)- viết tắt- mạch tổ hợp (International  Circuit)
icao	* (viết tắt)- Tổ chức hàng không dân dụng quốc tế (International  Civil  Aviation  Organization)- viết tắt- Tổ chức hàng không dân dụng quốc tế (International  Civil  Aviation  Organization)
icbm	* (viết tắt)- tên lửa đạn đạo liên lục địa (Inter-continental ballistic missile)
ice dancing	* danh từ- nghệ thuật múa trên băng
ice lolly	* danh từ- kem que, kem cây
ice-blue	* tính từ- xanh nhợt nhạt
ice-rink	* danh từ- sân trượt băng
ice-show	* danh từ- cuộc biểu diễn nghệ thuật trượt băng
ice-skating	* danh từ- thuật đi patanh trên băng
ice-tray	* danh từ- khay làm đá
iceless	- xem ice
ichthyornis	* danh từ- loại chim biển có răng (nay đã tuyệt chủng)
ichthyosaurian	* danh từ- thằn lằn cá; ngư long (đã tuyệt chủng)* tính từ- thuộc thằn lằn cá; thuộc ngư long
ichthys	* danh từ- hình cá tượng trưng chúa Giê xu
ici	* (viết tắt)- Công ty kỹ nghệ hoá chất hoàng gia (Imperial Chemical Industries)
icing sugar	* danh từ- đường dùng làm kem trứng
ickiness	- xem icky
iclinology	* danh từ- khoa nghiên cứu dấu chân hoá thạch
iconoclastically	- xem iconoclast
iconographer	- xem iconography
iconolatric	- xem iconolatry
iddd	* (viết tắt)- hệ thống gọi điện thoại đường dài quốc tế trực tiếp (international direct distance dialling)- viết tắt- hệ thống gọi điện thoại đường dài quốc tế trực tiếp (international direct distance dialling)
idealess	- xem idea
idealisation	* danh từ- sự lý tưởng hoá
idealistically	- xem idealistic
idempotent	* tính từ- (toán học) (thuộc ma trận) không thay đổi giá trị (sau khi tự nó nhân lên)* danh từ- số lượng toán học không thay đổi giá trị
identical twins	* danh từ- con sinh đôi giống nhau như đúc
identically	* phó từ- tương tự nhau, y hệt nhau
identicalness	- xem identical
identifiably	- xem identify
identification parade	* danh từ- cuộc xếp hàng để nhận diện kẻ phạm tội
identifier	- xem identify
identikit	* danh từ- <pháp> hình vẽ nhận dạng theo sự mô tả của các nhân chứng
ideogrammatic	- xem ideogram
ideogrammatically	- xem ideogram
ideographically	- xem ideograph
ideologically	* phó từ- về ý thức hệ
ideologue	* danh từ- nhà lý luận; người có những ý nghĩ hư ảo, không thực tế- người chủ trương một lý thuyết nào đó; nhà tư tưởng
ides	* danh từ- ngày 15 tháng Ba,  Năm,  Sáu hoặc tháng Mười (theo lịch La Mã cổ)
idioblast	* danh từ- (sinh học) dị bào
idioblastic	* tính từ- thuộc dị bào
idiolect	* danh từ- vốn từ vựng mà một người biết và sử dụng
idiolectal	- xem idiolect
idiolectic	- xem idiolect
idiomatically	* phó từ- phù hợp với phong cách bản ngữ
idiopathically	- xem idiopathic
idiosyncratically	- xem idiosyncrasy
idiotically	* phó từ- ngu si, ngu ngốc
idolatrously	* phó từ- với vẻ sùng bái, với vẻ tôn sùng
idolisation	* danh từ- sự thần tượng hoá- sự tôn sùng, sự sùng bái, sự chiêm ngưỡng
idolizer	- xem idolize
idyllically	* phó từ- bình dị, mộc mạc, thôn dã
ieee	- Viện các vấn đề kỹ thuật điện và điện tử
iffiness	- xem iffy
ifip	- (International Federation for Information Processing) Liên đoàn quốc tế về xử lí thông tin
ignescent	* tính từ- có thể phát ra tia lửa
ignitability	* danh từ- tình trạng có thể bắt lửa; tình trạng cháy bùng lên
ignitor	- xem ignite
ignobly	* phó từ- đê tiện, nhục nhã
ignominiously	* phó từ- nhục nhã, đê tiện
ignominiousness	- xem ignominious
ignorantly	* phó từ- ngu dốt, dốt nát
iguanid	* danh từ- loại thằn lằn Mỹ nhiệt đới
ikebana	* danh từ- nghệ thuật cắm hoa (chú trọng sự cân đối và hài hoà)
ikey	* danh từ- (khinh bỉ) người Do Thái* tính từ- thuộc người Do Thái
ilamb	* danh từ- xem aimbus
ileal	- xem ileum
ileitis	* danh từ- chứng viêm ruột hồi
iliad	* danh từ- câu chuyện kể dài (đặc biệt theo truyền thống Hôme)- một loạt chiến công thích hợp cho một thiên anh hùng ca- một loạt những khổ đau và bất hạnh (Iliad là thiên anh hùng ca Hy Lạp cổ miêu tả cuộc bao vây thành troa của người Hy Lạp)
ilka	* tính từ- mỗi, mỗi một
ill feeling	* danh từ- ác cảm, mối hận thù, nỗi oán hậnãm tài- sự khó chịu
ill will	* danh từ- ác ý, ác tâm
ill-advisedly	- xem ill-advised
ill-assorted	* tính từ- lẫn lộn, tạp nhạp- không xứng đôi vừa lứa
ill-behaved	* tính từ- vô lễ; mất dạy
ill-dressed	* tính từ- ăn mặc xoàng xĩnh; ăn mặc luộm thuộm
ill-manneredly	- xem ill-mannered
ill-natured	* tính từ- xấu tính, khó chịu- hay càu nhàu, hay cáu bẳn, hay gắt gỏng
ill-naturedly	- xem ill-natured
ill-naturedness	- xem ill-natured
ill-sorted	* tính từ- không xứng đôi vừa lứa, cọc cạch= He and his wife were an ill-sorted pair+Anh ấy và vợ là một đôi cọc cạch
ill-temperedly	- xem ill-tempered
illatively	- xem illative
illegalisation	* danh từ- sự làm cho bất hợp pháp, sự bất hợp pháp hoá
illegality	* danh từ- sự không hợp pháp; tính không hợp pháp- <snh> hành động không hợp pháp
illegalization	- sự làm cho bất hợp pháp, sự bất hợp pháp hoá
illegally	* phó từ- bất hợp pháp, trái pháp luật
illegibly	* phó từ- khó đọc
illegitimately	* phó từ- không hợp pháp, không chính đáng
illiberalism	- xem illiberal
illiberally	* phó từ- hẹp hòi, bần tiện
illicitly	- xem illicit
illimitably	- xem illimitable
illiquidity	- xem illiquid
illiterately	- xem illiterate
illogically	* phó từ- bất hợp lý, phi lý
illuminatingly	- xem illuminate
illuminist	* danh từ- người theo thuyết thiên cảm
illuministic	* tính từ- theo thuyết thiên cảm
illusional	- xem illusion
illusionary	- xem illusion
illusionistic	- xem illusionism
illusionistically	- xem illusionism
illusionless	- xem illusion
illusively	- xem illusive
illustrational	- xem illustration
illustratively	- xem illustrative
illustriously	* phó từ- lừng lẫy, trứ danh
ilmenite	* danh từ- (khoáng chất) inmenit
ilo	* (viết tắt)- Tổ chức lao động quốc tế (International Labour Organization)
imageless	- xem image
imaginability	- xem imaginable
imaginably	- xem imaginable
imaginarily	- xem imaginary
imaginational	- xem imagination
imaginatively	* phó từ- theo tính cách tưởng tượng
imagistically	- xem imagism
imaret	* danh từ- quán ăn hoặc nhà trọ cho khách vãng lai ở Thổ Nhĩ Kỳ
imbalanced	- xem imbalance
imbecilely	- xem imbecile
imbrown	* ngoại động từ- xem to embrown
imf	* (viết tắt)- Qũy tiền tệ quốc tế (International Monetary Fund)
imidazole	* danh từ- (hoá học) nhóm imiđo
imide	* danh từ- (hoá học) imit
imidic	* tính từ- (hoá học) thuộc imit
imitatively	- xem imitative
immaculately	- xem immaculate
immanently	- xem immanent
immaterially	- xem immaterial
immaterialness	- xem immaterial
immaturely	- xem immature
immeasurably	* phó từ- vô cùng, cực kỳ
immedicable	* tính từ- (nói về bệnh tật) không chữa khỏi được, nan y
immemorially	- xem immemorial
immersed	* tính từ- (cây cối) mọc hoàn toàn dưới nước
immersible	* tính từ- có thể nhận chìm xuống nước
immesh	* ngoại động từ- xem emmesh
immigration control	* danh từ- trạm kiểm soát nhập cảnh
imminently	* phó từ- sắp xảy ra
imminentness	- xem imminent
immiscibly	- xem immiscible
immitigableness	- xem immitigable
immitigably	- xem immitigable
immittance	* danh từ- mạch điện vào
immobilisation	* danh từ- sự cố định, sự giữ cố định; sự làm bất động- sự không di chuyển được; sự không nhúc nhích được (của quân đội, xe cộ...)- sự thu hồi không cho lưu hành (tiền...)
immobilizer	- xem immobilize
immoderately	* phó từ- quá độ, thái quá
immodestly	* phó từ- khiếm nhã, vô liêm sỉ
immorally	* phó từ- đồi bại, trái với luân thường đạo lý, vô luân
immortalisation	* danh từ- sự làm thành bất tử, sự làm cho bất diệt, sự làm thành bất hủ, sự làm lưu danh muôn thuở
immovably	* phó từ- bất di bất dịch, bất động
immunisation	* danh từ- <y> sự tạo miễn dịch, sự chủng ngừa
immunoadsorbent	* danh từ- chất ngoại hấp miễn dịch
immunochemistry	* danh từ- hoá học của hệ thống miễn dịch
immunogen	* danh từ- chất kháng nguyên
immunoglobulin	* danh từ- globulin miễn dịch
immunohaematology	* danh từ- miễn dịch học máu
immunologically	- xem immunology
immutably	* phó từ- bất biến, bất di bất dịch
imno	- Trong các hội nghị trực tuyến, đây là những ký tự vt của In My Humbbe Opinion
imo	* (viết tắt)- Tổ chức hàng hải quốc tế (International Maritime Organization)- viết tắt- Tổ chức hàng hải quốc tế (International Maritime Organization)
impalpably	- xem impalpable
impanelment	- xem impanel
imparisyllabic	* tính từ- có số âm tiết khác nhau trong những hình thức ngữ pháp khác nhau
impartially	* phó từ- công bằng, không thiên vị, vô tư
impartibly	- xem impartible
impassably	- xem impassable
impassibly	- xem impassible
impassively	* phó từ- bình thản, dửng dưng
impastoed	* tính từ- thuộc kỹ thuật dùng chất màu đậm đặc trong bức hoạ
impatiently	* phó từ- nóng lòng, nôn nóng, sốt ruột
impeccably	* phó từ- hoàn hảo, không chê vào đâu được
impecuniously	* phó từ- túng thiếu, túng quẫn
impendency	* danh từ- tình trạng sắp xảy đến, tình trạng sắp xảy đến trước mắt
impenetrably	* phó từ- không thể hiểu nổi, không thể thấu nổi
impenitently	* phó từ- không hối tiếc, chứng nào tật nấy
imperatively	* phó từ- với vẻ sai khiến, với vẻ ra lệnh
imperceptibly	* phó từ- không thể nhận thấy, không thể cảm thấy
imperfectly	* phó từ- dở dang, thiếu sót
imperialisation	* danh từ- sự đế quốc hoá (một chính thể)- sự đặt dưới quyền thống trị của hoàng đế- sự phong làm hoàng đế
imperialistically	- xem imperialism
imperially	* phó từ- uy nghi, đường bệ
imperiously	* phó từ- hống hách, độc đoán
imperishably	- xem imperishable
impermeably	- xem impermeable
impermissibly	- xem impermissible
impersonalisation	* danh từ- sự làm mất cá tính con người
impersonally	* phó từ- không nhằm vào ai, bâng quơ
impertinently	* phó từ- xấc láo, xấc xược
imperturbably	* phó từ- điềm tựnh, không nao núng
impervious	* tính từ- không thấu qua được, không thấm (nước...)- không tiếp thu được, trơ trơ- <Mỹ> không thể bị hư hỏng
imperviously	- xem impervious
impetuously	* phó từ- dữ dội, mãnh liệt
impinger	- xem impinge
impiously	* phó từ- bất kính, bất hiếu
impiousness	- xem impious
impishly	* phó từ- ranh mãnh, tinh ma quỷ quái
implacably	* phó từ- kiên quyết, nhất quyết
implantable	- xem implant
implausibleness	- xem implausible
implausibly	- xem implausible
implementer	- xem implement
implicatively	- xem implication
implicite	* tính từ- 1Ngầm 2 Hoàn toàn, tuyệt đối- implicites
implicitly	* phó từ- hoàn toàn
implicity	* danh từ- sự ngấm ngầm; sự ẩn ý- sự hoàn toàn, sự tuyệt đối
imploration	- xem implore
imploringly	* phó từ- khẩn nài, van xin
impolitely	* phó từ- vô lễ, bất lịch sự, khiếm nhã
impoliticly	- xem impolitic
imponderably	- xem imponderable
importantly	* phó từ- quan trọng, trội yếu
importunately	- xem importunate
importunely	- xem importune
importuner	- xem importune
imposingly	* phó từ- uy nghi, oai nghiêm, đường bệ
soul-searching	* danh từ- sự tự vấn lương tâm (sự kiểm tra sâu sắc lương tâm và tinh thần của mình)
soulfully	* phó từ- biểu lộ cảm xúc sâu sắc, tác động đến cảm xúc một cách sâu sắc, có hồn, làm xúc động sâu sắc
soullessly	* phó từ- không có tâm hồn; không có những cảm xúc cao cả hơn, không có những cảm xúc sâu sắc hơn (người)- không hồn, không có sức sống, tầm thường, nhạt nhẽo (về cuộc sống, công việc )
sound barrier	* danh từ- hàng rào âm thanh (điểm tại đó tốc độ của máy bay bằng tốc độ của sóng âm thanh, gây ra tiếng nổ âm thanh)
sound effect	* danh từ, pl- tiếng động (để gây tác động về không khí của hoàn cảnh)
sound-conducting	* tính từ- truyền âm; dẫn âm
sound-ranging	* danh từ- sự xác định khoảng cách bằng âm thanh
sound-recorder	* danh từ- máy ghi âm
sound-recording	* danh từ- sự ghi âm
sound-shift	* danh từ- sự thay đổi ngữ âm trong lịch sử ngôn ngữ
sounding-lead	* danh từ- dây dọi để đo độ sâu
soundly	* phó từ- một cách đứng đắn; hoàn toàn và đầy đủ
soupcon	* danh từ- (+of)  <đùa> chút, tí, thoáng; một lượng rất nhỏ; dấu vết
soupson	* danh từ- chút ít, dấu vết= a soupson of malice+chút ít ranh mãnh
sour cream	* danh từ- kem chua (dùng để chế các món thơm ngon)
sourdough	* danh từ- <Mỹ> bột nhào chua (để làm bánh mì)- <Mỹ> người có kinh nghiệm lâu trong việc mở đường, tìm kiếm vàng (ở Bắc Canada hoặc Alaska)
sourly	* phó từ- xem sour
soursop	* danh từ- (thực vật) cây mãng cầu xiêm
souschef	* danh từ- phó đầu bếp ở khách sạn
souterrain	* danh từ- đường đi dưới đất thời tiền sử
south african	* danh từ= (South African) Nam phi+dân Nam phi
south pole	* danh từ- (the South Pole) Nam cực (điểm xa nhất về phía nam của quả đất)
south-easterner	* danh từ- người ở vùng Đông nam
south-easternmost	* tính từ- cực đông nam
south-southeast	* tính từ,  adv, n+nam đông nam (giữa nam và tây nam)
south-southwest	* tính từ,  adv, n+nam tây nam (giữa nam va đông nam)
south-westerner	* danh từ- người ở tây nam
south-westernmost	* tính từ- cực tây nam
southeastward	* tính từ,  n- về phía đông nam
southeastwards	* phó từ- về phía đông nam
southern lights	* danh từ- Nam cực quang
southernise	* động từ- xem southernize
southernize	* động từ- Nam phương hoá
southernizm	* danh từ- cách phát âm, từ ngữ miền Nam nước Mỹ
southwester	* danh từ- gió tây nam (gió thổi mạnh từ tây-nam)
souwester	* danh từ- mũ không thấm nước (thường bằng vải dầu) có vành rộng ở phía sau để bảo vệ cổ- gió tây nam (gió mạnh thổi từ tây-nam)
sovereignly	* phó từ- xem sovereign
sovietisation	* danh từ- sự xô viết hoá
sovietism	* danh từ- chủ nghĩa xô viết; cộng sản
sovkhoz	* danh từ- số nhiều sovkhozes- nông trường quốc doanh
sowdrunk	* tính từ- say bí tỉ
soy sauce	* danh từ- tương; xì dầu
soya sauce	* danh từ- tương; xì dầu
sp	* (viết tắt)- chính tả (spelling)  (nhất là trên các bản viết đã sửa chữa)
space invaders	* danh từ- trò chơi điện tử phổ biến trong đó người chơi cố ngăn không cho các sinh vật từ vũ trụ đổ bộ xuống trái đất
space probe	* danh từ- tàu thăm dò vũ trụ (không người lái)
space shuttle	* danh từ- tàu con thoi (tàu vũ trụ được thiết kế để dùng lại nhiều lần)
space station	* danh từ- trạm vũ trụ
space-exploration	* danh từ- sự khảo sát vũ trụ
space-factor	* danh từ- hệ số chứa đầy
space-heating	* danh từ- sự sưởi ấm nhà ở
space-helmet	* danh từ- mũ để du hành vũ trụ
space-lattice	* danh từ- mạng không gian (của tinh thể)
space-launch	* danh từ- sự phóng con tàu vũ trụ
space-plafform	* danh từ- xem space station
space-radiation	* danh từ- bức xạ vũ trụ
space-telegraph	* danh từ- điện báo vô tuyến
spacebar	- thanh cách chữ (ở máy chữ)
spacecraft	- Cách viết khác : spaceship 
spaced-out	* tính từ- (thông tục) say như bị thuốc ma túy
spaceful	* tính từ- rộng rãi
spacemark	* danh từ- ký hiệu (- ) chỉ để trống trong tài liệu in
spacemedicine	* danh từ- y học trong du hành vũ trụ
spaceport	* danh từ- sân bay vũ trụ
spaceship	- như spacecraft
spacewalk	* danh từ- sự chuyển động trong không gian bên ngoài con tàu vũ trụ, khoảng thời gian chuyển động trong không gian
spacewalking	* danh từ- xem space-walk
spacewards	* phó từ- về phía không gian
spacewoman	* danh từ- nữ du hành vũ trụ
spacial	* tính từ- xem space
spaciously	* phó từ- rộng rãi; có được nhiều chỗ, kiếm được nhiều chỗ
spadesman	* danh từ- người đào mai
spadework	* danh từ- việc đào bằng mai- công việc chuẩn bị vất vả
spading	* danh từ- sự đào đất bằng mai
spallation	* danh từ- sự phá vỡ (hạt nhân nguyên tử)
spallbale	* tính từ- có thể đập vỡ được
spalling	* danh từ- sự đập vỡ; phá vỡ; nứt vỡ= thermal spalling+sự nứt vỡ do nhiệt
span-roof	* danh từ- nhà hai mái dốc cân nhau
spangles	* danh từ- số nhiều- hoa kẽm, vân hoa trên mặt tôn tráng kẽm
spangling	* danh từ- sự rắc trang kim
spanish main	* danh từ- (the Spanish Main) bờ biển đông bắc của Nam Mỹ và vùng biển Caribê gần bờ đó (tên gọi trước đây)
spare part	* danh từ- phụ tùng thay thế (cho máy móc, xe  khi bị hỏng, mất )
spare tyre	* danh từ- bánh xe dự phòng (của một chiếc ô tô )- <thgt><đùa> nếp mỡ bụng; bụng phệ
spare-part	* danh từ- phần để thế bộ phận máy hỏng
spare-rib	* danh từ- sườn lợn lọc gần hết thịt
spare-tyre	* danh từ- bụng phệ
sparely	* phó từ- thanh đạm- gầy gò
spareness	* danh từ- (sự) tiết kiệm; để dành- (sự) thanh đạm; mộc mạc- (sự) để thay thế- (sự) gầy gò
sparge	* nội động từ- vảy nước, rảy nước
sparget	* danh từ- ống vảy nước- máy rắc (ủ bia)
sparingly	* phó từ- thanh đạm, sơ sài- tiết kiệm, tằn tiện, dè xẻn, không hoang phí
spark-over	* danh từ- tâm chắn tia lửa
sparking	* danh từ- sự loé lửa; phát ra tia lửa
sparks	* danh từ- người thợ điện, người coi tổng đài (nhất là trên một con tàu)
sparkwear	* danh từ- sự cháy mòn
sparky	* tính từ- sôi nổi; sinh động
sparsely	* phó từ- thưa thớt, rải rác, lơ thơ; rải mỏng ra
sparsity	* danh từ- sự thưa thớt, sự rải rác, sự lơ thơ; sự rải mỏng ra
spartacan	* tính từ- thuộc Xpactacút (người cầm đầu cuộc khởi nghĩa nô lệ ở cổ La-Mã)* danh từ- người thuộc đảng Xpactacút
spartacism	* danh từ- sách lược Xpactacút
spasmodically	* tính từ- <y> co thắt- lúc có lúc không; lác đác; thảng hoặc; không đều đặn, không liên tục- (thuộc) co thắt; do co thắt; gây ra bởi các cơn co thắt, bị tác động bởi các cơn co thắt- đột biến
spasmolytic	* tính từ- chống co thắt; trị co thắt* danh từ- thuốc trị co thắt
spathaceous	* tính từ- có mo
spathed	* tính từ- có mo
spathose	* tính từ- xem spathiform
spathulate	* tính từ- (thực vật) dạng bay; dạng thìa
spatially	* phó từ- (thuộc) không gian; nói về không gian, có trong không gian
spatio-temporally	* phó từ- thuộc không gian; thời gian
spawner	* danh từ- cá đẻ trứng
spawning	* danh từ- sự đẻ trứng (tôm, cá); thời gian đẻ trứng
speakable	* tính từ- có thể nói đến
speaking clock	* danh từ- <thgt> dịch vụ điện thoại báo giờ
speargun	* danh từ- dụng cụ để phóng xiên đâm cá (dưới nước)
speary	* tính từ- hình cây giáo
special branch	* danh từ- (Special Branch) Cơ quan đặc vụ
special constable	* danh từ- người được đào tạo để giúp đỡ cảnh sát nhất thời, đặc biệt trong tình trạng khẩn cấp
special delivery	* danh từ- dịch vụ chuyển bưu phẩm đặc biệt
special licence	* danh từ- giấy cho phép một đám cưới được tổ chức vào một thời gian hay địa điểm mà bình thường không được phép
special pleading	* danh từ- <pháp> sự biện hộ ngụy biện
special school	* danh từ- trường học dành cho trẻ tàn tật
special student	* danh từ- <Mỹ> sinh viên ở một trường đại học Mỹ không theo một lớp có học vị
specialisation	* danh từ- sự chuyên môn hoá- <sinh> sự chuyên hoá
specialised	* tính từ- chuyên dụng; thích ứng, thiết kế cho một mục đích riêng- chuyên; (thuộc) chuyên gia, liên quan đến chuyên gia
specialized	* tính từ- chuyên dụng; thích ứng, thiết kế cho một mục đích riêng- chuyên; (thuộc) chuyên gia, liên quan đến chuyên gia
speciational	* tính từ- thuộc sự hình thành loài
specific gravity	* danh từ- trọng lượng riêng, tỷ trọng
specified	* tính từ- theo danh nghĩa; lý thuyết
speciogenesis	* danh từ- sự hình thành loài
speciously	* phó từ- chỉ có bề ngoài; chỉ tốt mã; chỉ có lý ở bề ngoài; có vẻ hợp lý
specked	* tính từ- có đốm bẩn
speckled	* tính từ- có những đốm nhỏ
spectacles	* danh từ, pl- kính đeo mắt
spectacularly	* phó từ- đẹp mắt; tráng lệ; ngoạn mục; hùng tráng- thu hút sự chú ý
spectate	* nội động từ- có mặt với tư cách người xem (trận đấu bóng...)
spectator sports	* danh từ- những môn thể thao thu hút nhiều khán giả (bóng đá )
spectrality	* danh từ- tính quang phổ
spectrally	* phó từ- xem spectral
spectralnes	- xem spectrality
spectro	- hình thái ghép có nghĩa quang phổ= spectrogram+ảnh quang phổ
spectrographic	* tính từ- thuộc máy chụp ảnh quang phổ; máy phổ ký
spectrography	* danh từ- phép chụp ảnh quang phổ
spectroheliogram	* danh từ- ảnh chụp phổ mặt trời
spectroheliography	* danh từ- phép chụp phổ mặt trời
spectrology	* danh từ- khoa phân tích quang phổ
spectrometric	* tính từ- thuộc phổ kế
spectroscopic	* tính từ- (thuộc) kính quang phổ; bằng phương tiện kính quang phổ
speculatory	* tính từ- xem speculative
speech therapist	* danh từ- người được đào tạo để làm việc điều trị cho những người khuyết tật về ngôn ngữ bằng phương pháp đặc biệt
speech therapy	* danh từ- phương pháp điều trị đặc biệt để giúp người có khuyết tật về ngôn ngữ nói rõ ràng hơn
speechlessly	* tính từ- mất tiếng, tắt tiếng, không nói được (vì giận, buồn )- không thể diễn đạt bằng lời- <lóng> say mèm
speed-ball	* danh từ- (liều) tiêm côcain lẫn hêrôin
speed-counter	* danh từ- cái chỉ tốc độ
speed-indicator	* danh từ- đồng hồ tốc độ
speed-reading	* danh từ- cách đọc nhanh; đọc lướt
speedily	* phó từ- <thgt> mau lẹ, nhanh, nhanh chóng- ngay lập tức, không chậm trễ (làm việc, đi đến )
speedo	* danh từ- xem speedomiter
speedomiter	* danh từ- đồng hồ tốc độ, công tơ mét
speer	- Cách viết khác : speir 
spelaelogical	* tính từ- (thuộc) môn học về hang động, (thuộc) hang động học
spelaelogy	* danh từ- hang động học, môn học về hang động
speleological	* tính từ- (thuộc) môn học về hang động, (thuộc) hang động học
speleologist	* danh từ- người nghiên cứu hang động
speleology	* danh từ- hang động học, môn học về hang động
spelican	- Cách viết khác : spilikin 
spellbinding	* tính từ- làm xuất thần, làm mê ly; thu hút sự chú ý (do một câu thần chú )
spelunker	* danh từ- (từ Mỹ, người Mỹ) người thích khảo sát hang động
spelunking	* danh từ- sự thích khảo sát hang động
spencerian	* tính từ- thuộc học thuyết Spencer
spencerianism	* danh từ- học thuyết Spencer
spermagonium	* danh từ- số nhiều spermagonia- túi chứa tinh tử
spermaphore	* danh từ- giá noãn* danh từ- giá noãn
spermaphyte	* danh từ- (thực vật) thực vật có hạt; hoa hiện
spermatheca	* danh từ- túi nhận tinh
spermatid	* danh từ- tinh tử; tiền tinh trùng
spermatium	* danh từ- số nhiều spermatia- tinh tử; bào tử phấn
spermatocyte	* danh từ- khoang chứa tinh
spermatogonium	* danh từ; số nhiều spermatogonia- nguyên bào tinh
spermatorhea	- Cách viết khác : spermatorhoea 
spermicidal	* tính từ- (thuộc) chất diệt tinh trùng
spermicide	* danh từ- chất diệt tinh trùng
spermicidol	* tính từ- (thuộc) thuốc diệt tinh trùng
spermid	* danh từ- tinh tử, tiền tinh trùng
spermiducal	* tính từ- (thuộc) ống dẫn tinh; (thuộc) tinh quản
spermiduct	* danh từ- như vas deferens
spermin	* danh từ- hocmon tinh hoàn
spermiogenesis	* danh từ- sự phát triển tinh trùng (từ tinh tử)
spermogonial	* tính từ- thuộc túi bào tử phấn; túi chứa tinh
spermogonium	* danh từ- số nhiều spermogonia- túi bào tử phấn; túi chứa tinh
spermophyte	* danh từ- thực vật có hạt; hoa hiện
sperrylife	* danh từ- (khoáng) Xperilit
spessartine	* danh từ- (khoáng) Xpexactin
spessartite	* danh từ- xem spessartine
spewing	* danh từ- sự khạc nhổ; nôn mửa
sphacelation	* danh từ- sự gây bệnh thối hoại- sự mắc bệnh thối hoại
sphalerite	* danh từ- (khoáng) Xfalêrit
sphene	* danh từ- (khoáng) Xfen
sphenic	* tính từ- dạng nêm
spher-	- xem shero-,  shaer-,  sphaero-+hình thái ghép có nghĩa hình cầu : spheroid dạng cầu
spheral	* tính từ- hình cầu; dạng cầu- hết sức cân đối; hài hoà
spheroidization	* danh từ- (luyện kim) sự tạo thành hạt tròn
spherula	* danh từ- cầu nhỏ; tiểu cầu- cầu gai nhỏ
spherulite	* danh từ- tinh thể hình cầu
spherulitic	* tính từ- thuộc tinh thể hình cầu
sphingidae	* danh từ- (động vật) họ bướm sư tử
sphygmic	* tính từ- thuộc mạch
sphygmoid	* danh từ- sự đập mạch
sphynx	* danh từ- xem sphinx
spic	- Cách viết khác : spik 
spic-and-span	* tính từ- xem spick-and-span
spicebush	* danh từ- (thực vật) an tức hương
spiced	* tính từ- chứa một thứ gia vị, chứa nhiều gia vị; được nêm gia vị; có gia vị
spicily	* phó từ- có bỏ gia vị- sắc sảo; dí dỏm; thú vị- lịch sự; bảnh bao
spick-and-span	* tính từ- gọn gàng, ngăn nắp và sạch sẽ= they always keep their kitchen spick and span+họ luôn giữ căn bếp của họ ngăn nắp sạch sẽ- mới toanh, bảnh bao (người)
spicula	* danh từ- số nhiều spiculae- cái gai
spiculum	* danh từ- số nhiều spicula- có gai
spider-man	* danh từ- người làm việc trên chỗ rất cao khi xây các toà nhà
spider-men	* danh từ- người làm việc trên chỗ rất cao khi xây các toà nhà
spider-plant	* danh từ- cây nhện (có lá mỏng, và thân dài từ đó các cây non mọc lên)
spider-wort	* danh từ- (thực vật) rau trai
spiffling	* tính từ- (thông tục) rất cừ
spik	- Cách viết khác : spic 
spike lavender	* danh từ- cây oải hương
spike-drawer	* danh từ- búa (xà beng) nhổ đinh ray
spike-driver	* danh từ- búa đóng đinh ray
spike-hammer	* danh từ- búa tán đinh ray
spike-like	* tính từ- dạng bông
spike-nail	* danh từ- đinh rất lớn
spiked	* tính từ- (thực vật) có bông- có mấu nhọn; có đinh mấu
spikefish	* danh từ- (động vật) cá cờ
spikelet-like	* tính từ- dạng bông nhỏ
spikes	* danh từ, pl- giầy đinh (của vận động viên)- đinh dài, ghim dài (bằng kim loại)- bông (của ngũ cốc )- nhánh
spiking	* danh từ- sự đóng đinh ray
spillage	* danh từ- sự đổ ra; lượng bị đổ ra
spilling	* danh từ- sự lọt không khí qua dù- dãy cọc chống đất tụt
spillover	* danh từ- (vô tuyến điện) sự tràn tín hiệu
spiloma	* danh từ- nốt ruồi
spin-dry	* ngoại động từspin-dried+quay cho khô (quần áo)
spin-off	* danh từ- sản phẩm phụ; lợi ích phụ
spina	* danh từ- cái gai
spina bifida	* danh từ- <y> tật nứt đốt sống (gây nên ốm yếu tàn tật nghiêm trọng)
spinal column	* danh từ- cột sống; xương sống lưng
spinal corn	* danh từ- tủy sống
spinant	* danh từ- chất kích thích tủy sống
spinate	* tính từ- có gai
spination	* danh từ- sự phân bố gai
spindle-fibres	* danh từ; số nhiều- sợi thoi
spine chilling	* tính từ- lạnh xương sống; khủng khiếp
spine-bearing	* tính từ- có gai, chứa gai
spine-chiller	* danh từ- phim (chuyện) làm nổi gai ốc, phim (chuyện) rùng rợn
spine-chilling	* tính từ- làm nổi gai ốc; khủng khiếp= the spine-chilling consequences of a nuclear war+những hậu quả khủng khiếp của một cuộc chiến tranh hạt nhân
spinelessly	* phó từ- không xương sống (động vật )- <bóng> yếu đuối, ẻo lả; nhút nhát, dễ run sợ, nhu nhược- không có gai- không có ngạnh (cá)
spinelessness	* danh từ- tính chất không xương sống (động vật )- <bóng> tính yếu đuối, tính ẻo lả; tính nhút nhát, tính dễ run sợ, tính nhu nhược- tính chất không có gai- tính chất không có ngạnh (cá)
spinelet	* danh từ- gai nhỏ@a
